He lives in a big house	Dia tinggal dalam rumah besar
There is a new book on the table	Di meja ada buku baru
He is my best friend	Dia adalah teman baikku
He has gone to the market	Dia telah pergi ke pasar
You want tea or coffee	Kamu mau teh atau kopi
I like to eat rice	Saya suka makan nasi
For me, it's important	Bagi saya, itu penting
I've already had lunch	Saya sudah makan siang
He has many friends	Dia memiliki banyak teman
I haven't had lunch yet	Saya belum makan siang
I like coffee, but tea is better	Saya suka kopi, tetapi teh lebih enak
What are you doing?	Apa yang kamu lakukan?
This is not my book	Ini bukan buku saya
He left without permission	Dia pergi tanpa izin
Don't forget to bring an umbrella	Jangan lupa membawa payung
Where are my car keys?	Mana kunci mobilku?
Who came today	Siapa yang datang hari ini
He is the champion of the competition	Dia sang juara lomba tersebut
How much does this book cost	Berapa harga buku ini
Let's go together	Mari kita pergi bersama
Yes, I understand now	Iya, saya mengerti sekarang
Let's go to the market	Ayo kita pergi ke pasar
He chose another path	Dia memilih jalan lain
I have one book	Saya punya satu buku
I have two cats	Saya punya dua kucing
Me and him are the same	Saya dan dia sama
This is very important for us	Hal ini sangat penting untuk kita
He has a new car	Dia punya mobil baru
It's very sunny today	Hari ini cuaca sangat cerah
He's still at home	Dia masih di rumah
Self-love is important	Cinta diri itu penting
I bought some new books	Saya membeli beberapa buku baru
I like to eat fresh fruit	Saya suka makan buah segar
The price of the item rose dramatically	Harga barang tersebut naik drastis
It's a cozy place	Ini tempat yang nyaman
I started learning Indonesian	Saya mula belajar bahasa Indonesia
Of course I will help	Tentu saya akan membantu
She goes to school in the morning	Dia pergi ke sekolah pagi
One day we will meet	Suatu saat kita akan bertemu
The world is colorful	Dunia ini penuh warna-warni
She has three cats	Dia punya tiga kucing
We must solve this problem	Kita harus menyelesaikan masalah ini
Our main focus is education	Fokus utama kita adalah pendidikan
Please help me, yes	Tolong bantu saya, ya
I drink cold water	Saya minum air dingin
My name is Andi	Nama saya Andi
I accept the gift	Saya terima hadiah itu
I have a new book	Saya punya buku baru
Police caught the thief earlier	Polisi menangkap pencuri tadi
He sells fresh fruit	Dia jual buah segar
Health is very important	Kesehatan itu sangat penting
I went to the market	Saya pergi ke pasar
I live in Jakarta	Saya tinggal di Jakarta
This food is very healthy	Makanan ini sangat sehat
I know him from school	Saya kenal dia dari sekolah
He stood in front of the house	Dia berdiri di depan rumah
He will definitely come tomorrow	Dia pasti datang besok
Our teacher teaches patiently	Guru kami mengajar dengan sabar
Today is a new beginning	Hari ini adalah awal baru
Please take the book	Tolong ambil buku itu
Let me ask you something	Aku ingin tanya sesuatu
The car was red in color	Mobil itu berwarna merah
I think it's a great idea	Aku pikir itu ide bagus
He raised his left hand	Dia mengangkat tangan kirinya
My home is far from here	Rumahku jauh dari sini
This road is very long	Jalan ini sangat panjang
The child has a small ball	Anak itu punya bola kecil
He lives in the west of the city	Dia tinggal di barat kota
I read a new book	Saya membaca buku baru
This room is very comfortable	Kamar ini sangat nyaman
I like reading books	Saya suka baca buku
I went to the office	Saya pergi ke kantor
I have four books	Saya punya empat buku
Sunrise from the east	Matahari terbit dari timur
The weather is cool tonight	Malam ini cuacanya sejuk
The woman reading a book	Wanita itu membaca buku
The flower has a red color	Bunga itu memiliki warna merah
Wait a little longer	Tunggu sedikit lagi ya
He lives in the south of the city	Dia tinggal di selatan kota
I like learning in class	Saya suka belajar di kelas
The doctor helps his patient	Dokter itu membantu pasiennya
I have five apples	Saya punya lima apel
Please give me your phone number	Tolong berikan nomor teleponmu
The ticket costs one thousand rupiah	Biaya tiketnya seribu rupiah
I have to pay the electricity bill	Saya harus bayar tagihan listrik
I love that new movie	Saya suka film baru itu
My car keys are missing	Kunci mobil saya hilang
I love nature photos	Saya suka foto alam
I love playing in the sea	Saya suka bermain di laut
The city is located in the north	Kota itu terletak di utara
I forgot my phone at home	Saya lupa telepon di rumah
I want to repeat that song	Saya ingin ulang lagu itu
I went to the market yesterday	Saya pergi ke pasar kemarin
He almost arrived late	Dia hampir terlambat datang
This shirt is cheap and good	Baju ini murah dan bagus
My wife cooks delicious food	Istriku memasak makanan enak
The airplane was flying high	Pesawat itu terbang tinggi
The man is walking fast	Pria itu sedang berjalan cepat
The rainy season is here again	Musim hujan datang lagi
I live on the island	Saya tinggal di pulau itu
Earth rotates in its orbit	Bumi berputar di orbitnya
He stopped there	Dia berhenti di sana
The fish is very fresh	Ikan itu sangat segar
Wait for me for a moment	Tunggu saya sebentar ya
The forest is full of life	Hutan itu penuh dengan kehidupan
The building was newly built	Gedung itu baru dibangun
I want to drink water	Saya ingin minum air
Our meeting is on Monday	Pertemuan kita hari Senin
Our meeting is on Wednesday	Pertemuan kita hari Rabu
Push the door slowly	Dorong pintu itu pelan-pelan
I love morning coffee	Saya suka kopi pagi
I have a meeting on Thursday	Saya ada rapat Kamis
Our meeting on Tuesday	Pertemuan kita pada Selasa
I like listening to music	Saya suka mendengarkan musik
He arrived on time	Dia tiba tepat waktu
Today is Friday	Hari ini adalah Jumat
He is rich in experience	Dia kaya akan pengalaman
The flower is white	Bunga itu berwarna putih
The child throws stones	Anak itu melempar batu
I went to the bookstore	Saya pergi ke toko buku
She feels weak today	Dia merasa lemah hari ini
The flower is red	Bunga itu berwarna merah
My husband works in an office	Suami saya bekerja di kantor
Today's weather is very bad	Cuaca hari ini sangat buruk
Today's weather is very hot	Cuaca hari ini sangat panas
I watch the news on television	Saya menonton berita di televisi
The ship sailed to the island of	Kapal itu berlayar ke pulau
School vacation starts December	Liburan sekolah dimulai Desember
I was born in January	Saya lahir di Januari
He has six new books	Dia punya enam buku baru
He's afraid of the dark	Dia takut gelap
I was born in June	Saya lahir di bulan Juni
I climbed a high mountain	Saya mendaki gunung tinggi
Close the door slowly	Tutup pintu perlahan-lahan
Cold weather in October	Cuaca dingin di Oktober
The fire is burning brightly	Api sedang menyala terang
Sometimes I go cycling	Kadang saya pergi bersepeda
The air here is fresh	Udara di sini segar
He went down the river	Dia menyusuri sungai itu
Vacation starts in July	Liburan dimulai pada Juli
Call him here	Panggil dia ke sini
Let's meet again in August	Kita bertemu lagi Agustus nanti
We went to the beach today	Kami pergi ke pantai hari ini
The month of May comes brightly	Bulan Mei datang dengan cerah
Heavy rain falling tonight	Hujan turun deras malam ini
We went on vacation on Saturday	Kami pergi berlibur sabtu
I forgot to bring my card	Saya lupa membawa kartu
The tree grows tall	Pohon itu tumbuh tinggi
He rides a bicycle to school	Dia naik sepeda ke sekolah
Forest fires are very dangerous	Kebakaran hutan itu sangat bahaya
The cat is black	Kucing itu berwarna hitam
We're planning a February vacation	Kita berencana liburan Februari
Today is sunny afternoon	Hari ini cuaca cerah siang
He has seven books	Dia punya tujuh buku
He cuts the wood carefully	Dia memotong kayu dengan hati-hati
I love grilled meat	Saya suka daging panggang
The princess is very beautiful	Putri itu sangat cantik
The flower is very beautiful	Bunga itu sangat cantik
My son likes to play soccer	Putra saya suka bermain bola
She likes to run in the morning	Dia suka lari pagi
Sorry, I came late	Maaf, saya terlambat datang
The leaves of the tree are green	Daun pohon itu hijau
Her hair is long and beautiful	Rambutnya panjang dan indah
The cow is eating grass	Sapi itu sedang makan rumput
I like to drink milk	Saya suka minum susu
I feel tired this afternoon	Saya merasa sore ini lelah
He has eight new books	Dia punya delapan buku baru
The sun is shining brightly today	Matahari bersinar terang hari ini
This shirt is too expensive for me	Baju ini terlalu mahal untukku
The car turned left	Mobil itu belok ke kiri
We crossed the wooden bridge	Kami melewati jembatan kayu
Add sugar to coffee	Tambahkan gula ke dalam kopi
She brushes her teeth every morning	Dia menyikat gigi setiap pagi
The flower is yellow	Bunga itu berwarna kuning
This chair is comfortable to sit on	Kursi ini nyaman untuk duduk
He is busy working	Dia sedang sibuk bekerja
He's got a big mouth	Dia punya mulut besar
The wind blows gently this afternoon	Angin berhembus lembut sore ini
She gave a sweet smile	Dia memberikan senyum manis
I like to drink coffee	Saya suka minum kopi
I buy fresh eggs	Saya membeli telur segar
I have a beautiful dream	Saya punya mimpi indah
He bought new clothes	Dia membeli baju baru
I need a roadmap	Saya butuh peta jalan
This fruit tastes sweet	Buah ini rasanya manis
The child's cry was loud	Tangis anak itu terdengar keras
This floor is dirty and sticky	Lantai ini kotor dan lengket
There are nine books in there	Ada sembilan buku di sana
I went to a new restaurant	Saya pergi ke restoran baru
Today's weather is quite warm	Cuaca hari ini cukup hangat
He arrived in ten seconds	Dia tiba dalam sepuluh detik
Stars adorn the night sky	Bintang-bintang menghiasi langit malam
She looked at her face in the mirror	Dia melihat wajahnya di cermin
I live there	Saya tinggal di situ
I send you my regards	Saya mengirimkan salammu
Today's weather is quite sunny	Cuaca hari ini cukup cerah
Children's laughter echoes in the garden	Tawa anak-anak menggema di taman
Today's sky is blue	Langit hari ini berwarna biru
She bought a new bag	Dia membeli tas baru
I cook in the kitchen	Saya memasak di dapur
He was injured on the finger	Dia terluka di jari
I like to drink tea	Saya suka minum teh
The driver drove carefully	Sopir itu mengemudikan dengan hati-hati
He plays tennis every afternoon	Dia bermain tenis setiap sore
These pants are too tight	Celana ini terlalu ketat
She brings a bottle of mineral water	Dia membawa botol air mineral
The dog ran fast	Anjing itu berlari cepat
Grandma makes delicious cookies	Nenek membuat kue lezat
I need salt for cooking	Saya butuh garam untuk masak
He opened the bedroom window	Dia membuka jendela kamar
I feel hungry now	Saya merasa lapar sekarang
He holds a glass of water	Dia memegang gelas air
Reading is my hobby	Membaca adalah hobi saya
The cat is sleeping	Kucing itu sedang tidur
I like to eat apples	Saya suka makan apel
I like to eat bananas	Saya suka makan pisang
He plays guitar in the park	Dia bermain gitar di taman
I like to eat bread	Saya suka makan roti
My nose is blocked because of the flu	Hidungku tersumbat karena flu
I called an online taxi	Saya memanggil taksi online
My exam score is zero	Nilai ujian saya nol
I like orange juice	Saya suka jus jeruk
This chili sauce tastes very spicy	Sambal ini terasa pedas sekali
My wallet is lost at the market	Dompetku hilang di pasar
He plays the drums well	Dia bermain drum dengan baik
Pick up the spoon at the table	Ambil sendok di meja
He's wearing a new hat	Dia memakai topi baru
He writes with a red pen	Dia menulis dengan pena merah
She is wearing a red skirt	Dia mengenakan rok merah
Excuse me, I'm coming through	Permisi, saya mau lewat
I need a new pencil	Saya butuh pensil baru
I like to eat raw carrots	Saya suka makan wortel mentah
I like to eat chicken soup	Saya suka makan sup ayam
Hello how are you today	Halo, apa kabar hari ini
She plays the violin beautifully	Dia bermain biola dengan indah
Pick up the fork at the table	Ambil garpu di meja
Exam results are out	Hasil ujian sudah keluar
He is able to complete the task	Dia mampu menyelesaikan tugas
I need the latest information	Saya butuh informasi terbaru
I need your help now	Saya butuh bantuanmu sekarang
He holds the steering wheel tightly	Dia memegang kemudi dengan erat
He is indeed very smart	Dia memang pintar sekali
Humans need to help each other	Manusia perlu saling membantu
Our team won the match	Tim kami menang pertandingan tadi
We have different opinions	Kita punya pendapat yang beda
He comes from that country	Dia berasal dari negeri itu
He has two million rupiah	Dia memiliki dua juta rupiah
He is a member of our team	Dia adalah anggota tim kami
Our plan is ready	Rencana kita sudah matang
The president announced a new policy	Presiden mengumumkan kebijakan baru
Religion unites many people	Agama mempersatukan banyak orang
I train dogs every day	Saya latih anjing setiap hari
He hasn't answered that question yet	Dia belum jawab pertanyaan itu
Social activities in this village	Kegiatan sosial di desa ini
Politics influences daily life	Politik mempengaruhi kehidupan sehari-hari
This location is very strategic for business	Lokasi ini sangat strategis untuk bisnis
He is our representative	Dia adalah wakil kami
I am now happier	Saya kini lebih bahagia
I bought a new tool	Saya membeli alat baru
He started a new business	Dia memulai bisnis baru
Technology makes everyday life easier	Teknologi memudahkan kehidupan sehari-hari
He has a thousand billion rupiah	Dia memiliki seribu miliar rupiah
I've made a shopping list	Saya sudah buat daftar belanja
I need medicine for pain	Saya butuh obat untuk sakit
My position here is secure	Posisi saya di sini aman
He plays an important role	Dia memegang peran penting
She was born in Jakarta	Dia lahir di Jakarta
I believe in your ability	Saya percaya pada kemampuanmu
This morning's bird sounds are melodious	Suara burung pagi ini merdu
I consider you a good friend	Saya anggap kamu teman baik
I am sure you can	Saya yakin kamu bisa
She looks happy today	Dia tampak bahagia hari ini
He studies at a famous university	Dia kuliah di universitas terkenal
He is a strong opponent	Dia adalah lawan yang kuat
This method is efficient and effective	Metode ini efisien dan efektif
The temperature today is quite low	Suhu hari ini cukup rendah
Blood flows in my body	Darah mengalir di tubuhku
He achieved great success	Dia meraih sukses besar
This machine works well	Mesin ini bekerja dengan baik
He rejected the offer	Dia tolak tawaran itu
Watch out slippery road ahead	Awas, jalan licin di depan
Renewable energy is important for the environment	Energi terbarukan penting untuk lingkungan
This document is official	Dokumen ini sudah resmi
I want to join the group	Saya ingin gabung ke grup
Investment reaches trillions of rupiah	Investasi mencapai triliun rupiah
Let's count the amount together	Mari hitung jumlahnya bersama
We need electricity to study	Kita membutuhkan listrik untuk belajar
The king is wise and just	Raja itu bijaksana dan adil
The skin of this fruit is very delicious	Kulit buah ini sangat lezat
I am learning to use a computer	Saya belajar menggunakan komputer
She is very smart in mathematics	Dia amat pintar dalam matematika
The soldiers maintain the security of the country	Tentara menjaga keamanan negara
Access to information for the public is limited	Akses informasi untuk publik terbatas
We help each other	Kita saling membantu satu sama lain
The warmth of the soul brings happiness	Kehangatan jiwa membuat bahagia
The foreign language is difficult to understand	Bahasa asing itu sulit dipahami
This week there is a cultural festival	Pekan ini ada festival budaya
He failed to achieve his goal	Dia gagal mencapai tujuannya
This food uses local ingredients	Makanan ini menggunakan bahan lokal
The war was very terrifying	Perang itu sangat mengerikan
We join the labor union	Kita bergabung dengan serikat pekerja
You are coming tomorrow right	Kamu datang kan besok
Let him choose	Biar dia yang memilih
He went to the city today	Dia pergi ke bandar hari ini
She is wearing a gold ring	Dia mengenakan cincin emas
The floor of this house has just been painted	Lantai rumah ini baru dicat
Today feels perfect	Hari ini terasa sempurna
The book is open to page 10	Buku itu terbuka di halaman 10
I am satisfied with the result	Saya puas dengan hasilnya
Water flows through the channel	Air mengalir melalui salur itu
Christ brings hope for us	Kristus membawa harapan bagi kita
Her face looks very cheerful	Wajahnya terlihat sangat ceria
I am worried about this exam	Saya khawatir tentang ujian ini
Prayer is our hope	Doa adalah harapan kita
Everyone is present except for him	Semua hadir kecuali dia
The distance to his house is quite far	Jarak rumahnya cukup jauh
I go to the post office	Saya pergi ke pos kantor
The factory operates every day	Pabrik itu beroperasi setiap hari
I go to the mosque every Friday	Saya pergi ke masjid setiap Jumat
She plays in the flower garden	Dia bermain di kebun bunga
New books are in the library	Buku-buku baru ada di pustaka
I have to take a test tomorrow	Saya harus mengikuti tes besok
My class schedule is full today	Jadwal kuliah saya padat hari ini
I went shopping for daily necessities	Saya pergi belanja kebutuhan sehari-hari
The ball broke when it fell	Bola itu pecah saat jatuh
I always care about you	Aku peduli padamu selalu
This road is too narrow for cars	Jalan ini terlalu sempit untuk mobil
She dares to try new things	Dia berani mencoba hal baru
The guest came bringing fruits	Tamu datang membawa buah-buahan
He went to church this week	Dia pergi ke gereja minggu ini
I am fasting	Saya sedang menjalani puasa
This land is dry and cracked	Tanah ini kering dan retak
He is waiting at the station	Dia menunggu di stasiun
My phone screen is broken again	Layar ponselku pecah lagi
I am proud to be Indonesian	Saya bangga menjadi Indonesia
I read the book	Saya membaca kitab itu
He has a smart brain	Dia punya otak yang cerdas
She likes to sing in the room	Dia suka nyanyi di kamar
I forgot his address	Saya lupa alamat rumahnya
He rarely comes here	Dia jarang datang ke sini
Sir have you arrived	Tuan, apakah Anda sudah datang
The story is very inspiring	Kisah itu sangat menginspirasi
The green leaves are fresh	Daun hijau itu segar
An earthquake occurred at night	Gempa terjadi di malam hari
Changes occur every century	Perubahan terjadi setiap abad
I am always honest with you	Saya selalu jujur pada kamu
This fruit tastes fresh	Buah ini terasa segar
I like to cook fried rice	Saya suka masak nasi goreng
The parking lot is full	Tempat parkir sudah penuh
The student studies diligently	Murid itu belajar dengan giat
He is a great soccer player	Dia pemain sepak bola hebat
I like to drink coconut water	Saya suka minum air kelapa
The bone broke when it fell	Tulang itu patah saat jatuh
This sentence is easy to understand	Kalimat ini mudah dipahami
I bought a new camera	Saya membeli kamera baru
He expressed his emotions clearly	Dia mengungkapkan emosinya dengan jelas
We have a secret together	Kita punya rahasia bersama
I feel disappointed today	Saya merasa kecewa hari ini
The wind is blowing from the southeast	Angin bertiup dari tenggara
The bird has a long beak	Burung itu memiliki paruh panjang
She feels happy today	Dia merasa gembira hari ini
I read the latest magazine	Saya membaca majalah terbaru
The family gathers during Eid	Keluarga berkumpul saat lebaran
Our neighbor just moved in	Tetangga kami baru pindah
My stomach is hungry after exercising	Perutku lapar setelah berolahraga
My car tire is flat	Ban mobil saya kempes
The population of this city continues to grow	Populasi kota ini terus berkembang
The match was canceled due to rain	Pertandingan itu batal karena hujan
The Christmas atmosphere feels warm	Suasana natal terasa hangat
The car's wheels spin fast	Roda mobil itu berputar cepat
The artist looks charming today	Artis itu tampil menawan hari ini
This paper is very thin	Kertas ini sangat tipis
He is holding my chest	Dia memegang dada saya
I read the text	Saya membaca teks itu
The children are playing in the sand	Anak-anak bermain di pasir
I like sweet chocolate	Saya suka cokelat manis
The truck is carrying heavy goods	Truk itu membawa barang berat
She climbs the high hill	Dia mendaki bukit tinggi
He started to dig a new hole	Dia mulai gali lubang baru
I like swimming in the morning	Saya suka renang di pagi
He has strong muscles	Dia memiliki otot yang kuat
He is my assistant	Dia adalah asisten saya
The actor played well	Aktor itu bermain dengan baik
My shirt got wet	Baju saya menjadi basah
The book has thick pages	Buku itu memiliki halaman tebal
These shoes are made of rubber	Sepatu ini terbuat dari karet
I go to the clinic in the evening	Saya pergi ke klinik sore
He writes on the board	Dia menulis di papan
I read the newspaper every morning	Saya membaca koran setiap pagi
The horse runs fast	Kuda itu berlari cepat
I hate hot weather	Saya benci cuaca panas
I like fried rice	Saya suka nasi goreng
She gives a sweet kiss	Dia memberi cium manis
I am going to the concert tonight	Saya pergi ke konser malam ini
I bought red onions	Saya membeli bawang merah
He is sick in his back	Dia sakit di punggungnya
The roof of the house is leaking	Atap rumah itu bocor
The rope is too short	Tali itu terlalu pendek
The flag is waving in the wind	Bendera itu berkibar di angin
The queen wore a beautiful crown	Ratu itu mengenakan mahkota indah
His tongue feels very spicy	Lidahnya terasa pedas sekali
He is a Catholic young man	Dia seorang pemuda katolik
The object is made of metal	Benda itu terbuat dari logam
The children are playing on the grass	Anak-anak bermain di rumput
The button is not working	Tombol itu tidak berfungsi
Smoke from the kitchen billows high	Asap dari dapur mengepul tinggi
The garden gate has been opened	Gerbang taman sudah dibuka
The ring is made of silver	Cincin itu terbuat dari perak
My car is in the garage	Mobil saya di garasi
The boat sails on the river	Perahu itu berlayar di sungai
The elephant is eating grass	Gajah itu sedang makan rumput
The prince is handsome and wise	Pangeran itu tampan dan bijaksana
Science helps understand our world	Sains membantu memahami dunia kita
The human lungs need oxygen	Paru-paru manusia membutuhkan oksigen
This honey tastes sweet	Madu ini rasanya manis
My neck feels sore today	Leherku terasa sakit hari ini
Life without love is like hell	Kehidupan tanpa cinta seperti neraka
He has a high fever	Dia mengalami demam tinggi
The tower looks magnificent	Menara itu terlihat megah
I like red chili	Saya suka cabai merah
The ship is anchored in the bay	Kapal berlabuh di teluk itu
The rat ran fast	Tikus itu berlari cepat
This ice cream is already frozen	Es krim ini sudah beku
I went to the mall today	Saya pergi ke mal hari ini
The storm is coming tonight	Badai datang malam ini
I like to go to the cafe	Saya suka pergi ke kafe
He is sick in the knee	Dia sakit di lutut
The snake crossed the road	Ular itu melintas di jalan
I like going to the theater	Saya suka pergi ke teater
The child jumps high	Anak itu lompat tinggi
He raised his right arm	Dia mengangkat lengan kanannya
Hi how are you?	Hai, apa kabar kamu?
He is sick in his waist	Dia sakit di pinggangnya
I forgot my glasses at home	Saya lupa kacamata di rumah
She is cutting vegetables with a knife	Dia memotong sayur dengan pisau
Uncle came from afar	Paman datang dari jauh
I see the calendar this month	Saya melihat kalender bulan ini
I like chocolate cream	Saya suka krim cokelat
I am carrying a red umbrella	Saya membawa payung merah
She plays with a new doll	Dia bermain dengan boneka baru
I bought new soap	Saya membeli sabun baru
I forgot to bring my passport	Saya lupa membawa paspor
I like sweet mangoes	Saya suka mangga manis
The duck is swimming	Bebek itu sedang berenang
I am looking for an English dictionary	Saya mencari kamus bahasa Inggris
I bought a new jacket	Saya membeli jaket baru
The flower is purple	Bunga itu berwarna ungu
She is wearing a new bracelet	Dia memakai gelang baru
The pillow is very soft	Bantal itu sangat empuk
He coughed after the rain	Dia batuk setelah hujan
I am waiting in the hotel lobby	Saya menunggu di lobi hotel
She pinched my cheek	Dia mencubit pipi saya
I like strawberry flavored candy	Saya suka permen rasa stroberi
I like fried potatoes	Saya suka kentang goreng
I like to eat satay	Saya suka makan sate
She took a new comb	Dia mengambil sisir baru
I bought fresh tomatoes	Saya membeli tomat segar
Snow covers the entire road	Salju menutupi seluruh jalan
The stove is already lit	Kompor itu sudah menyala
I bought new sandals	Saya membeli sandal baru
The rabbit jumps high	Kelinci itu melompat tinggi
A rainbow appears after the rain stops	Pelangi muncul setelah hujan reda
The lion is the king of the jungle	Singa adalah raja hutan
I like cheddar cheese	Saya suka keju cheddar
My throat feels sore	Tenggorok saya terasa sakit
This carpet is very comfortable to use	Karpet ini sangat nyaman digunakan
The refrigerator is full of food	Kulkas itu penuh dengan makanan
The monkey is playing amusingly	Monyet itu sedang bermain lucu
He bought a new shirt	Dia membeli kemeja baru
I like chili sauce	Saya suka saus sambal
She moved her hips gracefully	Dia menggerakkan pinggulnya dengan lincah
I need a clean towel	Saya butuh handuk bersih
Please lift this item with the elevator	Tolong angkat barang ini lift
The sun sets in the desert	Matahari terbenam di gurun
I bought a red envelope	Saya membeli amplop merah
I like to eat papaya	Saya suka makan pepaya
I am looking for scissors at home	Saya mencari gunting di rumah
He is wearing a new belt	Dia mengenakan sabuk baru
The ambulance arrived quickly	Ambulans datang dengan cepat
Her eyebrows look very beautiful	Alisnya terlihat sangat indah
I like sweet soy sauce	Saya suka kecap manis
I like cold beer	Saya suka bir dingin
My aunt came to visit	Bibi saya datang berkunjung
I feel disgusted seeing it	Saya merasa jijik melihatnya
The chef cooks well	Koki itu memasak dengan baik
I like buttered bread	Saya suka roti mentega
The spider is crawling	Laba-laba itu sedang merayap
I like fruit yogurt	Saya suka yoghurt buah
I caught a cold again	Saya terkena pilek lagi
I like apple cider vinegar	Saya suka cuka apel
We will meet the day after tomorrow	Kita akan bertemu lusa
I like strawberry jam	Saya suka selai stroberi
I bought new shampoo	Saya membeli sampo baru
Add pepper to the soup	Tambahkan merica pada sup
I like fresh lettuce	Saya suka selada segar
I like mayonnaise on sandwiches	Saya suka mayones di sandwich
Society needs to help each other	Masyarakat perlu saling membantu
Flowers bloom in the beautiful garden	Bunga kembang di taman indah
Let's continue learning together	Mari kita lanjut belajar bersama
The law must be enforced fairly	Hukum harus ditegakkan dengan adil
This system needs to be fixed	Sistem ini perlu diperbaiki
The Indonesian economy continues to grow rapidly	Ekonomi Indonesia terus berkembang pesat
Thus is the result of this research	Demikianlah hasil penelitian ini
The minister announced a new policy	Menteri mengumumkan kebijakan baru
This discount is two percent	Diskon ini sebesar dua persen
They attended communion with family	Mereka menghadiri komuni bersama keluarga
This activity is very interesting to me	Aktivitas ini sangat menarik bagi saya
I will report the incident	Saya akan lapor kejadian itu
The plant is growing well	Tanaman itu tumbuh dengan baik
The source of information is reliable	Sumber informasi itu terpercaya
He is the victim of the accident	Dia adalah korban kecelakaan itu
Farmers work in the rice fields every day	Petani bekerja di sawah setiap hari
This institution provides free training	Lembaga ini menyediakan pelatihan gratis
He earned a bachelor's degree	Dia meraih gelar sarjana
Our nation is rich in culture	Bangsa kita kaya akan budaya
The technology industry is growing rapidly	Industri teknologi semakin berkembang pesat
Our efforts are bearing fruit	Upaya kita membuahkan hasil
The influence of friends is very large	Pengaruh teman sangat besar
Clean water consumption increased drastically	Konsumsi air bersih meningkat drastis
The action attracted the attention of many people	Aksi tersebut menarik perhatian banyak orang
This province has many tourist attractions	Provinsi ini memiliki banyak wisata
This organization needs new members	Organisasi ini membutuhkan anggota baru
We guarantee the quality of this product	Kami jamin kualitas produk ini
This project requires more funding	Proyek ini membutuhkan lebih banyak dana
I lift the bag	Saya angkat tas itu
Fish trapped in a net	Ikan terperangkap dalam jaring
He is my biological sibling	Dia adalah saudaraku kandung
We will discuss this topic later	Kita bahas topik ini nanti
Taxes must be paid on time	Pajak harus dibayar tepat waktu
The governor visited the new school	Gubernur mengunjungi sekolah baru
We must move forward together	Kita harus maju bersama-sama
Indonesia is a democratic republic	Indonesia adalah sebuah republik demokratis
The regent attended the opening event	Bupati menghadiri acara pembukaan
Art is an important part of life	Seni adalah bagian penting hidup
Don't disturb me now	Jangan ganggu saya sekarang
I am conducting this study	Saya sedang melakukan studi ini
We warmly welcome guests	Kami sambut tamu dengan hangat
The internet access here is fast	Akses internet di sini cepat
The secretary is very professional	Sekretaris itu sangat profesional
This design is very eye-catching	Desain ini sangat menarik perhatian
The test result is positive and good	Hasil tesnya positif dan baik
He feels deep suffering	Dia merasakan derita yang mendalam
I want to print this document	Saya ingin cetak dokumen ini
This tradition is passed down through generations	Tradisi ini diwariskan turun-temurun
I received extra points	Saya mendapatkan poin tambahan
The guardian is present at school	Wali murid hadir di sekolah
He follows the same pattern	Dia mengikuti pola yang sama
This book falls into the fiction category	Buku ini masuk kategori fiksi
This shirt is suitable for you	Baju ini cocok untukmu
The meaning of life is important to us	Makna hidup itu penting bagi kita
The latest news is in the bulletin	Berita terbaru ada di warta
Jesus teaches us love	Yesus mengajarkan kasih kepada kita
We need to reduce imports of goods	Kita perlu mengurangi impor barang
I am participating in the running competition this year	Saya ikut kompetisi lari tahun ini
The campus is busy during the day	Kampus itu ramai saat siang
Exports of goods increased this year	Ekspor barang meningkat tahun ini
Both teams played to a draw	Kedua tim bermain imbang
The document is ready to be printed	Dokumen itu sudah siap dicetak
The military decision is controversial	Keputusan militer itu kontroversial
I challenge you to play	Saya tantang kamu bermain.
He brings weapons at home	Dia membawa senjata di rumah
This situation needs immediate attention	Situasi ini perlu perhatian segera
This research object attracts attention	Objek penelitian ini menarik perhatian
Every individual has unique potential	Setiap individu memiliki potensi unik
He is seriously studying today	Dia serius belajar hari ini
We will hold a discussion tomorrow	Kami akan adakan diskusi besok
She is the type of person who is patient	Dia tipe orang yang sabar
I want to rent a car	Saya ingin sewa mobil
I have a large debt	Saya punya utang yang besar
The theme of this event attracts attention	Tema acara ini menarik perhatian
He comes from the Minangkabau tribe	Dia berasal dari suku Minangkabau
I am waiting for the package to arrive	Saya menunggu paket datang
The general gave an order	Jenderal itu memberikan perintah
He is an adult now	Dia sudah dewasa sekarang
The teenager is studying together	Remaja itu sedang belajar bersama
First impressions are always important	Kesan pertama selalu penting
We live in peace	Kita hidup dalam damai
The story is very short	Cerita itu sangat singkat
This electronic device is advanced	Perangkat elektronik ini canggih
You must study every day	Kamu mesti belajar setiap hari
I like mixing colors	Saya suka campur warna.
The design of the shirt is unique and interesting	Desain baju itu unik dan menarik
May I borrow a book?	Bolehkah saya pinjam buku?
Volcanic ash covers the village	Abu vulkanik menyelimuti desa
Our staff works well	Staf kami bekerja dengan baik
The table is made of teak	Meja itu terbuat dari jati
My book collection is very diverse	Koleksi buku saya sangat beragam
The group is practicing together	Grup itu sedang berlatih bersama
She goes to early school	Dia pergi ke sekolah dini
This food is very popular here	Makanan ini sangat populer di sini
The test results showed a negative value	Hasil tesnya menunjukkan nilai negatif
This is the latest version of the application	Ini adalah versi terbaru aplikasi
This department needs a new budget	Departemen ini membutuhkan anggaran baru
He intentionally arrived late	Dia sengaja datang terlambat
Chemistry lessons are very interesting	Pelajaran kimia sangat menarik
We walked around the park	Kami berjalan keliling taman
Do not touch that item	Jangan sentuh barang itu
She studies at an art institute	Dia belajar di institut seni
I paid the toll on the road	Saya membayar tol di jalan
The weather conditions today are severe	Kondisi cuaca hari ini parah
He got out of prison	Dia keluar dari penjara
He urged me to go	Dia desak saya untuk pergi
The radio broadcast attracted attention	Siar radio itu menarik perhatian
Why didn't you come?	Kok kamu tidak datang?
The children chase the ball together	Anak-anak kejar bola bersama
She studies diligently every day	Dia belajar rajin setiap hari
Shopping centers are always crowded with visitors	Sentra perbelanjaan selalu ramai pengunjung
The allocation of funds for education has increased	Alokasi dana untuk pendidikan meningkat
She took a deep breath	Dia mengambil napas dalam-dalam
Please delete this writing	Tolong hapus tulisan ini
Thanks to his hard work success came	Berkat usaha kerasnya, sukses datang
I like car racing	Saya suka balap mobil
The match score is very high	Skor pertandingan itu sangat tinggi
They are similar to twin siblings	Mereka mirip seperti saudara kembar
The match at the stadium tonight	Pertandingan di stadion malam ini
This knife is very sharp	Pisau ini sangat tajam
We need specific information	Kita butuh informasi spesifik
He is my arch-enemy	Dia adalah musuh bebuyutan saya
I am confused about choosing food	Saya bingung memilih makanan
He is a friendly person	Dia orang yang ramah
This content is interesting to read	Konten ini menarik untuk dibaca
He found a bomb on the road	Dia menemukan bom di jalan
We need to understand the context	Kita perlu memahami konteksnya
I like studying mathematics	Saya suka belajar matematika
We explore the beauty of the archipelago	Kita menjelajahi keindahan nusantara
Rice grows lush in the fields	Padi tumbuh subur di sawah
They participated in the demonstration in Jakarta	Mereka ikut demonstrasi di Jakarta
I want to stay at the hotel	Saya ingin inap di hotel
I live in a new apartment	Saya tinggal di apartemen baru
The patient's condition is very critical	Kondisi pasien sangat kritis
The climate of Indonesia is quite diverse	Iklim Indonesia cukup beragam
The fisherman returned with fish	Nelayan itu pulang dengan ikan
The patient's medical report is ready	Laporan medis pasien sudah siap
This discount is valid until next week	Diskon ini berlaku hingga minggu depan
The professor teaches mathematics	Profesor itu mengajar matematika
Items are stored in the warehouse	Barang-barang disimpan di gudang
The roots of the tree are very strong	Akar pohon itu sangat kuat
We are in a safe zone	Kita berada di zona aman
Please fold that shirt	Tolong lipat baju itu
Today is a special day	Hari ini adalah hari spesial
The internet connection is very slow	Koneksi internetnya sangat lambat
He is smart in mathematics	Dia pintar dalam matematika
I am learning the alphabet letters	Saya belajar huruf alfabet
This cable is cut here	Kabel ini terputus di sini
This topic is interesting to discuss	Topik ini menarik untuk dibahas
The plastic bag is torn	Kantong plastik itu robek
Please send your contact here	Silakan kirim kontakmu di sini
The fire in the house is out	Api di rumah padam
Mud covers the village road	Lumpur menutupi jalan desa
He kicked the ball	Dia tendang bola itu
Put the book on the table	Taruh buku di meja
This color combination attracts attention	Kombinasi warna ini menarik perhatian
I remember my childhood	Aku kenang masa kecilku
I opened a new account	Saya membuka rekening baru
She visited her grandmother's grave	Dia mengunjungi kubur neneknya
Our hero inspires many people	Pahlawan kita menginspirasi banyak orang
This fabric is very smooth	Kain ini sangat halus
The cat is wild and naughty	Kucing itu liar dan nakal
The poison is dangerous for humans	Racun itu berbahaya bagi manusia
The seeds of this plant have grown	Benih tanaman ini sudah tumbuh
It's your turn to play now	Giliranmu untuk bermain sekarang
He broke the national record	Dia memecahkan rekor nasional
This condition requires emergency action	Kondisi ini membutuhkan tindakan darurat
This road is straight and safe	Jalan ini lurus dan aman
My favorite food is sushi	Makanan favorit saya sushi
This year's fashion trend is interesting	Tren fashion tahun ini menarik
The goat is eating grass	Kambing itu sedang makan rumput
He received a gold medal	Dia menerima medali emas
I feel regret about that decision	Saya merasa sesal atas keputusan itu
I am taking an English course	Saya mengikuti kursus bahasa Inggris
Soybeans are a source of plant protein	Kedelai adalah sumber protein nabati
I participate in the badminton tournament	Saya ikut turnamen bulu tangkis
I read the Bible every day	Saya membaca Alkitab setiap hari
The internet signal here is weak	Sinyal internet di sini lemah
My boss is busy	Bos saya sedang sibuk
I like boiled corn	Saya suka jagung rebus
Tourists enjoy the beauty of the beach	Turis menikmati keindahan pantai
She walked slowly towards the house	Dia berjalan perlahan menuju rumah
She feels anxious before the exam	Dia merasa cemas menjelang ujian
She has been feeling stressed lately	Dia merasa stres akhir-akhir ini
This chapter explains the basic concepts	Bab ini menjelaskan konsep dasar
The lyrics of that song are very beautiful	Lirik lagu itu sangat indah
He was amazed to see the view	Dia takjub melihat pemandangan itu
The children are playing at the fence	Anak-anak bermain di pagar
Our team captain is experienced	Kapten tim kami berpengalaman
Water flows through the pipe	Air mengalir melalui pipa
He sits on the park bench	Dia duduk di bangku taman
I am lazy to study today	Saya malas belajar hari ini
The flower bloomed beautifully this morning	Bunga itu mekar indah pagi ini
The shirt is ugly and dirty	Baju itu jelek dan kotor
I do not drink alcohol	Saya tidak minum alkohol
I am curious about that story	Saya penasaran dengan cerita itu
Dust sticks to the table	Debu menempel di meja
I like reading comics	Saya suka membaca komik
The pastor gave a sermon this morning	Pendeta memberikan khotbah pagi ini
The bird built a new nest	Burung itu membangun sarang baru
The blue ocean looks beautiful	Samudra biru terlihat indah
This food is already rotten	Makanan ini sudah busuk
I need emotional therapy	Saya butuh terapi emosional
The ghost appeared suddenly	Hantu itu muncul tiba-tiba
This shrimp is fresh and delicious	Udang ini segar dan enak
I want to download a new application	Saya ingin unduh aplikasi baru
He always behaves politely	Dia selalu bersikap sopan
He lifted the sword	Dia mengangkat pedang itu
The child is very naughty	Anak itu sangat nakal
He shot the arrow accurately	Dia menembakkan panah tepat sasaran
They are twins	Mereka adalah saudara kembar
The rocket soared into the sky	Roket itu meluncur ke langit
I suffer from severe diarrhea	Saya menderita diare parah
This food is delicious and appetizing	Makanan ini lezat dan menggugah selera
The children are playing cheerfully	Anak-anak bermain dengan ceria
My friend always supports me	Sobatku selalu mendukungku.
I wake up at dawn	Saya bangun saat subuh
We walk in the green valley	Kita berjalan di lembah hijau
She ties her hair with a ribbon	Dia mengikat rambutnya dengan pita
I like spicy meatballs	Saya suka bakso pedas
She is wearing a red dress	Dia memakai gaun merah
She is jealous of my friend	Dia cemburu pada teman saya
The coin is made of copper	Koin itu terbuat dari tembaga
Fog envelops the peaceful morning	Kabut menyelimuti pagi yang tenang
I bought wheat at the market	Saya membeli gandum di pasar
I take pills every day	Saya minum pil setiap hari
This password is easy to remember	Sandi ini mudah diingat
My skin itches after being bitten by a mosquito	Kulitku gatal setelah digigit nyamuk
This rose flower is very fragrant	Bunga mawar ini harum sekali
The book is on the shelf	Buku itu ada di rak
This pond is quite shallow today	Kolam ini cukup dangkal hari ini
I bought a discount coupon	Saya membeli kupon diskon
The weather this evening is cold	Cuaca petang ini sejuk
We celebrate Easter with family	Kami merayakan Paskah bersama keluarga
She is wearing that beautiful necklace	Dia mengenakan kalung indah itu
I like to drink warm ginger	Saya suka minum jahe hangat
I like playing volleyball	Saya suka bermain voli
I bought new glue	Saya membeli lem baru
I like sweet red guava	Saya suka jambu merah manis
I like to eat chicken porridge	Saya suka makan bubur ayam
I take a motorcycle taxi to the office	Saya naik ojek ke kantor
She walked in the quiet hallway	Dia berjalan di lorong sepi
I bought flour at the market	Saya membeli terigu di pasar
He found an old coin	Dia menemukan koin tua
He brings a new rifle	Dia membawa senapan baru
My son-in-law came to visit	Menantu saya datang berkunjung
The suitcase is too heavy to carry	Koper itu terlalu berat untuk dibawa
I like fresh pineapple	Saya suka nanas segar
Come here let's get started	Ayo kemari, kita mulai
We took a ferry to the island	Kami naik feri ke pulau
My jaw feels sore today	Rahangku terasa sakit hari ini
He has a thick mustache	Dia memiliki kumis tebal
I bought pumpkin for soup	Saya membeli labu untuk sup
I like mango syrup	Saya suka sirop mangga
I like sweet watermelon	Saya suka semangka manis
The school bell rings loudly	Bel sekolah berbunyi keras
The pot is already rusty	Panci itu sudah berkarat
He carries a bucket full of water	Dia membawa ember berisi air
I collect rare stamps	Saya mengumpulkan prangko langka
I need to iron this shirt	Saya perlu setrika baju ini
She touches her chin while thinking	Dia menyentuh dagunya sambil berpikir
I like chocolate biscuits	Saya suka biskuit cokelat
He is wearing a red tie	Dia mengenakan dasi merah
The door handle is rusty	Gagang pintu itu berkarat
I like to eat broccoli	Saya suka makan brokoli
I bought new sheets	Saya membeli seprai baru
I bought a dozen eggs	Saya membeli satu lusin telur
The fox runs fast	Rubah itu berlari cepat
I like to eat strawberries	Saya suka makan stroberi
I like chocolate donuts	Saya suka donat cokelat
Hey how are you?	Hei, apa kabar kamu?
I like red bell peppers	Saya suka paprika merah
She tightly holds my pinky	Dia menggenggam kelingkingku erat
I like playing baseball	Saya suka bermain bisbol
I like pepperoni pizza	Saya suka piza pepperoni
I like to eat spaghetti	Saya suka makan spageti
The learning process requires time	Proses belajar memerlukan waktu
I invite friends to my house	Saya undang teman-teman ke rumah
The operation went smoothly	Operasi itu berjalan lancar
The commission is having an important meeting	Komisi itu sedang rapat penting
Time management is important	Manajemen waktu itu penting
He likes to trade at the market	Dia suka berdagang di pasar
Weather effects influence crop yields	Efek cuaca mempengaruhi hasil panen
We must share the responsibility	Kita harus tanggung jawab bersama
He is a presidential candidate	Dia adalah calon presiden
The enemy is starting to attack our base	Musuh mulai serang markas kita
His attitude is always positive and friendly	Sikapnya selalu positif dan ramah
Your steps towards success are clear	Langkahmu menuju kesuksesan jelas
I need permission to go	Saya butuh izin untuk pergi
Weather factors affect crop yields	Faktor cuaca mempengaruhi hasil panen
The growth of the technology sector is rapidly increasing	Pertumbuhan sektor teknologi meningkat pesat
The agricultural land is fertile	Lahan pertanian itu subur
The meeting starts at nine in the morning	Rapat dimulai pukul sembilan pagi
I downloaded a new application	Saya mengunduh aplikasi baru
Young people need to innovate	Kaum muda perlu berinovasi
I choose the profession of doctor	Saya memilih profesi dokter
We must demand justice	Kita harus tuntut keadilan
The prophet brought the revelation of God	Nabi membawa wahyu Tuhan
Our team excels in the match	Tim kami unggul dalam pertandingan
This concept attracts the attention of many people	Konsep ini menarik perhatian banyak orang
Strive for maximum results at all times	Usahakan hasil maksimal setiap waktu
He threatened to leave	Dia mengancam akan pergi
This lesson material is very interesting	Materi pelajaran ini menarik sekali
The quality of this product meets the standards	Kualitas produk ini sesuai standar
There are interesting color variations	Ada variasi warna yang menarik
I need to focus now	Saya perlu fokus sekarang
We need a quick solution	Kami butuh solusi cepat
We must prevent fires	Kami harus cegah kebakaran
I take care of all the documents	Saya urus semua dokumen
The river water flows swiftly	Air sungai mengalir deras
The cell has an important function in the body	Sel itu berfungsi penting dalam tubuh
He studies at a music academy	Dia belajar di akademi musik
The younger generation has a lot of potential	Generasi muda memiliki banyak potensi
The car is transporting goods	Mobil itu mengangkut barang-barang.
I am following that latest promotion	Saya mengikuti promosi terbaru itu
He gave a quick response	Dia memberikan respons cepat
The tree has many branches	Pohon itu memiliki banyak cabang
Team coordination is very important	Koordinasi tim sangat penting
I read that latest article	Saya membaca artikel terbaru itu
The football league is currently ongoing	Liga sepak bola sedang berlangsung
I need that certificate	Saya butuh sertifikat itu
The selection process is going well	Proses seleksi berjalan dengan baik
Motivation is important to achieve goals	Motivasi penting untuk mencapai tujuan
I will monitor this development	Saya akan pantau perkembangan ini
The project is very complex and complicated	Proyek itu sangat kompleks dan rumit
They are attending a religious assembly today	Mereka menghadiri majelis agama hari ini
This system works efficiently	Sistem ini bekerja dengan efisien
She is completing her master's degree	Dia sedang menyelesaikan magister
Environmental issues need serious attention	Isu lingkungan perlu perhatian serius
He needs to control his emotions	Dia perlu kontrol emosi
I bought new health insurance	Saya membeli asuransi kesehatan baru
She likes to show off new things	Dia suka pamer barang baru
Cancer can affect anyone	Kanker dapat menyerang siapa saja
We must target this goal	Kita harus sasar target ini
The shadow looks faint	Bayang itu terlihat samar
The press plays an important role	Pers memainkan peran penting
The bridge is completely destroyed	Jembatan itu hancur total
He is focused on his career	Dia fokus pada kariernya
This change has a significant impact	Perubahan ini berdampak signifikan
The price is relatively affordable for everyone	Harganya relatif terjangkau untuk semua
The community feels the increasing terror	Masyarakat merasa teror yang meningkat
He is our cultural ambassador	Dia adalah duta budaya kita
He filed an insurance claim	Dia mengajukan klaim asuransi
Rainwater is absorbed by the soil	Air hujan diserap tanah
Their new album is released today	Album baru mereka rilis hari ini
I have an interview tomorrow	Saya punya wawancara besok
The travel agent is very professional	Agen perjalanan itu sangat profesional
Flu symptoms started to appear today	Gejala flu mulai muncul hari ini
I write a journal every day	Saya menulis jurnal setiap hari
The premiere of the film was a success	Peluncuran perdana film itu sukses
He praised his friend's work	Dia puji karya temannya
Please pack these items	Tolong kemas barang-barang ini
We must be patient while waiting	Kita harus sabar menunggu
A noble heart always shines	Hati yang mulia selalu bersinar
He works in the biology laboratory	Dia bekerja di laboratorium biologi
The new curriculum is implemented this year	Kurikulum baru diterapkan tahun ini
He will reply to your message	Dia akan balas pesanmu
That is a natural reaction	Itu adalah reaksi yang wajar
This system works automatically	Sistem ini bekerja secara otomatis
The survey results show high satisfaction	Hasil survei menunjukkan kepuasan tinggi
This project has a large scale	Proyek ini memiliki skala besar
I need to save money this month	Saya perlu hemat uang bulan ini
The construction of the bridge is underway	Konstruksi jembatan sedang berlangsung
This tube contains clean water	Tabung ini berisi air bersih
The background is very interesting	Latar belakangnya sangat menarik
He lives in a small cottage	Dia tinggal di pondok kecil
The harvest season has arrived	Musim panen telah tiba
This exercise is quite intense	Latihan ini cukup intens
The constitution protects the rights of citizens	Konstitusi melindungi hak warga
He suffered an injury while playing	Dia mengalami cedera saat bermain
How beautiful the view is here	Betapa indahnya pemandangan sini
This committee will hold a meeting	Komite ini akan mengadakan rapat
Human life is very precious	Nyawa manusia sangat berharga
The executive meeting started this morning	Rapat eksekutif dimulai pagi ini
You are my best friend	Engkau adalah teman terbaikku
I like posting new photos	Saya suka posting foto baru
He then went to the market	Dia lantas pergi ke pasar
Wait for confirmation from their side	Tunggu konfirmasi dari pihaknya
I am watching a new movie	Gue lagi nonton film baru
He kicks the ball into the goal	Dia menendang bola ke gawang
Either he has already left	Entah dia sudah pergi
Their love is pure and sincere	Cinta mereka murni dan tulus
Our client is satisfied with the service	Klien kami puas dengan layanan
This convention was attended by many people	Konvensi ini dihadiri banyak orang
I feel tense before the exam	Saya merasa tegang sebelum ujian
The flag is a symbol of our pride	Bendera itu simbol kebanggaan kita
We need oxygen to live	Kita butuh oksigen untuk hidup
Domestic economy is growing	Ekonomi domestik sedang tumbuh
The subject of this research is very important	Subjek penelitian ini sangat penting
The marketing division is having a meeting	Divisi pemasaran sedang rapat
Determine the coordinates of this location	Tentukan koordinat lokasi ini
This lamp requires 10 watts	Lampu ini membutuhkan 10 watt
This fabric feels smooth	Kain ini terasa halus
The conference will be held next week	Konferensi itu diadakan minggu depan
We need vitamins every day	Kita perlu vitamin setiap hari
They are involved in a heated debate	Mereka terlibat dalam debat sengit
There is a slight time difference	Ada selisih waktu sedikit
The base of the tree is strong	Pangkal pohon itu kuat
I like reading poetry	Aku suka membaca puisi
I am concerned about the environmental condition	Saya prihatini kondisi lingkungan
Slide the table to the side	Geser meja ke samping
The decision depends on the dependent	Keputusan itu tergantung pada dependen
She hugs her child tightly	Dia peluk anaknya erat
She has an extraordinary talent	Dia memiliki bakat luar biasa
Follow the instructions well	Ikuti instruksi dengan baik
The god protects us	Dewa itu melindungi kita
Wages for workers must be paid on time	Upah pekerja harus dibayar tepat
They are ready to fight	Mereka siap untuk tarung
The new regulation is implemented today	Regulasi baru diterapkan hari ini
I will install the new application	Saya akan instal aplikasi baru
This fish is still raw	Ikan ini masih mentah
Carbon is important for life	Karbon penting untuk kehidupan.
The flower is very rare here	Bunga itu sangat langka di sini
The cash is running low	Uang kas sudah menipis
He gave an inspiring speech	Dia memberikan pidato yang menginspirasi
This fabric feels soft	Kain ini terasa lembut
The iron plate is very heavy	Pelat besi itu sangat berat
The city was filled with giants	Kota itu dipenuhi raksasa.
The bird flies with wings	Burung itu terbang dengan sayap
The engineer designed a new bridge	Insinyur itu merancang jembatan baru
The national emblem is installed in the building	Lambang negara terpasang di gedung
I made a fence from bamboo	Saya membuat pagar dari bambu
He is a dangerous criminal	Dia seorang kriminal berbahaya
We need good nutrition	Kita perlu nutrisi yang baik
This construction is made of steel	Konstruksi ini terbuat dari baja
Please wrap this food	Tolong bungkus makanan ini
The referee gave a red card	Wasit memberikan kartu merah
He has been blind since birth	Dia buta sejak lahir
I watched the Olympics this year	Saya menonton Olimpiade tahun ini
Learning a language is easy	Belajar bahasa itu gampang
The deputy head of the school is present	Deputi kepala sekolah hadir
The kidneys function to filter blood	Ginjal berfungsi menyaring darah
I memorized that song	Saya hafal lagu itu
He showed genuine sympathy	Dia menunjukkan simpati yang tulus
The chain broke while being used	Rantai itu terputus saat digunakan
The company's board of directors held a meeting	Direksi perusahaan mengadakan rapat
I need a new recipe	Saya butuh resep baru
The hall is full of people	Aula itu penuh dengan orang
Today is my graduation	Hari ini adalah wisuda saya
The satellite orbits the Earth every day	Satelit mengorbit Bumi setiap hari
He likes professional boxing	Dia suka tinju profesional
She bought new accessories	Dia membeli aksesori baru
The bus fare is expensive now	Ongkos naik bus mahal sekarang
This class is private and exclusive	Kelas ini bersifat privat dan eksklusif
The satay skewers are really delicious	Tusuk sate itu enak banget
He wipes his sweat slowly	Dia menghapus keringatnya perlahan
His movements look stiff and slow	Gerakannya terlihat kaku dan lambat
The car suddenly braked	Mobil itu menginjak rem mendadak
He holds a long-standing grudge	Dia menyimpan dendam lama
I like to drink cocoa chocolate	Saya suka minum cokelat kakao
He stayed at the guesthouse	Dia menginap di wisma itu
She feels restless waiting for news	Dia merasa gelisah menunggu berita
The flower smells fragrant	Bunga itu berbau harum
Our team's supporters are very enthusiastic	Suporter tim kami sangat bersemangat
I need a warm blanket	Saya butuh selimut hangat
That is impossible to happen	Itu mustahil untuk terjadi
She found a rare gem	Dia menemukan permata langka
Instant food is easy to prepare	Makanan instan mudah disiapkan
The Asian continent has many cultures	Benua Asia memiliki banyak budaya
The result of this draw is random	Hasil undian ini acak
See the latest product catalog	Lihat katalog produk terbaru
A dragon flies in the night sky	Naga terbang di langit malam
He vomited after eating too much	Dia muntah setelah makan terlalu banyak
This camera lens is of high quality	Lensa kamera ini berkualitas tinggi
Father went to the market today	Bapa pergi ke pasar hari ini
Change the car oil every month	Ganti oli mobil setiap bulan
The crocodile is sunbathing	Buaya itu sedang berjemur
The children clap their hands together	Anak-anak tepuk tangan bersama
The helicopter is flying high	Helikopter itu terbang tinggi
I like mangosteen	Saya suka buah manggis
The waves at the beach are calm today	Ombak di pantai tenang hari ini
Today's temperature is quite high	Temperatur hari ini cukup tinggi
He is wearing a new helmet	Dia memakai helm baru
Calcium is important for bone health	Kalsium penting untuk kesehatan tulang
The film producer is famous in Jakarta	Produser film itu terkenal di Jakarta
He pretends not to know	Dia pura-pura tidak tahu
He whispered a secret to me	Dia bisik rahasia kepadaku
This silk fabric is very smooth	Kain sutra ini sangat halus
Children like to hear fairy tales	Anak-anak suka mendengar dongeng
That treatment is very cruel	Perlakuan itu sangat kejam
I am looking for that video clip	Saya mencari klip video itu
Lightning strikes with a flash	Petir menyambar dengan kilat
The typhoon destroyed our house	Topan itu menghancurkan rumah kami
I go to the coffee shop	Saya pergi ke kedai kopi
Birds chirp in the jungle	Burung berkicau di rimba
She felt deep joy	Dia merasakan sukacita mendalam
I bought new cute stickers	Saya membeli stiker lucu baru
We are staying at the new villa	Kami menginap di vila baru
He is holding the steering wheel of the car	Dia memegang setir mobil
I like peaches	Saya suka buah persik
The ring is made of diamond	Cincin itu terbuat dari intan
Her face is pale because of illness	Wajahnya pucat karena sakit
He carries a gun in the bag	Dia membawa pistol di tas
I go to Sunday mass	Saya pergi ke misa minggu
We explored the old tunnel	Kami menjelajahi terowongan tua
I like spicy chips	Saya suka keripik pedas
My luggage is lost at the airport	Bagasi saya hilang di bandara
The children are collecting shells on the beach	Anak-anak mengumpulkan kerang di pantai
He likes to chew gum	Dia suka kunyah permen karet
This peninsula is rich in culture	Semenanjung ini kaya budaya
She feels nervous before performing	Dia merasa gugup sebelum tampil
He looks handsome today	Dia tampak ganteng hari ini
I like to eat crab	Saya suka makan kepiting
He sleeps soundly tonight	Dia tidur nyenyak malam ini
I like to eat fresh spinach	Saya suka makan bayam segar
He sits on the balcony	Dia duduk di balkon
The cat looks cute	Kucing itu terlihat imut
Bats fly at night	Kelelawar terbang malam hari
The octopus is pink	Gurita itu berwarna merah muda
I am fed up with all this	Aku muak dengan semua ini
Children like watching dolphins	Anak-anak suka melihat lumba-lumba
I like to eat breakfast cereal	Saya suka makan sereal pagi
The morning sky is orange	Langit pagi berwarna jingga
Lotus flowers grow in the pond	Bunga teratai tumbuh di kolam
I like fried eggplant	Saya suka terung goreng
The black crow flies high	Gagak hitam terbang tinggi
I like fresh cabbage salad	Saya suka salad kubis segar
I like fresh cucumbers	Saya suka timun segar
This cake has a delicious vanilla flavor	Kue ini rasa vanili lezat
I like celery in salad	Saya suka seledri dalam salad
I bought a sponge for washing	Saya membeli spons untuk mencuci
The giraffe is eating leaves	Jerapah itu sedang makan daun
Santa Claus comes bringing gifts	Sinterklas datang membawa hadiah
I like to eat cherries	Saya suka makan ceri
The gorilla is eating a banana	Gorila itu sedang makan pisang
I like playing rugby	Saya suka bermain rugbi
He can manage that project	Dia bisa kelola proyek itu
Long-term investments are profitable	Investasi jangka panjang menguntungkan
We need the right strategy	Kami membutuhkan strategi yang tepat
Data analysis is needed for decisions	Analisis data diperlukan untuk keputusan
Corruption destroys public trust	Korupsi merusak kepercayaan publik
The structure of this building is very strong	Struktur bangunan ini kokoh sekali
Democracy is the right of every citizen	Demokrasi adalah hak setiap warga
He offers graphic design services	Dia menawarkan jasa desain grafis
He is the key witness of the case	Dia adalah saksi kunci kasus itu
Registration requires several conditions	Pendaftaran memerlukan beberapa syarat
The faculty of engineering is holding a seminar	Fakultas teknik sedang mengadakan seminar
Facing risks in investment	Menghadapi risiko dalam investasi
Company administration must be efficient	Administrasi perusahaan harus efisien
The mountain looks majestic	Gunung itu terlihat agung
The judge decided the case	Hakim memutuskan kasus tersebut
Natural disasters destroyed our village	Bencana alam menghancurkan desa kami
I have a new interest	Saya punya minat baru
The lecturer teaches in class today	Dosen mengajar di kelas hari ini
This theory is interesting to study	Teori ini menarik untuk dipelajari
The workload is getting heavier today	Beban kerja semakin berat hari ini
The capacity of this room is limited	Kapasitas ruangan ini terbatas
The distribution of goods is carried out evenly	Distribusi barang dilakukan secara merata
This city is famous for its mine	Kota ini terkenal dengan tambang
He stands upright there	Dia berdiri tegak di sana
He raises livestock in the village	Dia memelihara ternak di desa
We are facing an economic crisis now	Kita menghadapi krisis ekonomi sekarang
This conflict needs to be resolved immediately	Konflik ini perlu diselesaikan segera
The court decided the case	Mahkamah memutuskan perkara tersebut
I like this brand	Saya suka merek ini
Their leadership is very dominant	Kepemimpinan mereka sangat dominan
The use of narcotics is harmful to health	Penggunaan narkotika berbahaya bagi kesehatan
New legislation will be enacted	Legislasi baru akan diberlakukan
The term is often used here	Istilah itu sering digunakan di sini
She is skilled at cooking	Dia terampil dalam memasak
The quality of this product is quite good	Mutu produk ini cukup baik
Their contribution is very meaningful to the community	Kontribusi mereka sangat berarti bagi masyarakat
This event is very attention-grabbing	Ajang ini sangat menarik perhatian
Public transportation in Jakarta is crowded	Transportasi umum di Jakarta padat
Community participation is very important	Partisipasi masyarakat sangat penting
The campaign attracted the attention of many people	Kampanye itu menarik perhatian banyak orang
We walk in the green field	Kami berjalan di padang hijau
We are conducting new research	Kami melakukan riset baru
He is charged with committing a crime	Dia didakwa melakukan kejahatan
I need a recommendation for a new book	Saya butuh rekomendasi buku baru
I will give a presentation today	Saya akan memberikan presentasi hari ini
Statistics show an interesting trend	Statistik menunjukkan tren yang menarik
Health is our top priority	Kesehatan adalah prioritas utama kita
Follow the correct procedure	Ikuti prosedur yang benar
The education directorate held a seminar	Direktorat pendidikan mengadakan seminar
The agricultural land is 10 hectares wide	Lahan pertanian itu seluas 10 hektare
My concentration is starting to decline	Konsentrasi saya mulai menurun
The majority of the citizens support the change	Mayoritas warga mendukung perubahan
Customs must be respected	Adat istiadat harus dihormati
The company's profit increased this year	Laba perusahaan meningkat tahun ini
Self-identity needs to be maintained	Identitas diri perlu dijaga
The cape is beautiful and calm	Tanjung itu indah dan tenang
This city is always dynamic and lively	Kota ini selalu dinamis dan hidup
The artwork is full of inspiration	Karya seni itu penuh inspirasi
The publication of the research is very important	Publikasi penelitian itu sangat penting
Bacteria can cause serious illness	Bakteri dapat menyebabkan penyakit serius
He always works hard	Dia senantiasa berusaha keras
He is always consistent in work	Dia selalu konsisten dalam kerja
The antique item is being auctioned today	Barang antik itu dilelang hari ini
Early detection of disease is very important	Deteksi dini penyakit sangat penting
The architect designs modern buildings	Arsitek merancang gedung modern
The airline offers a big discount	Maskapai itu menawarkan diskon besar
Environmentally friendly nuclear energy	Energi nuklir ramah lingkungan
He retired last year	Dia sudah pensiun tahun lalu
They held a peaceful protest	Mereka mengadakan protes damai
Inspections are conducted every month	Inspeksi dilakukan setiap bulan
He was arrested for bribery	Dia ditangkap karena suap
Its natural resources are abundant	Sumber daya alamnya limpah
We will meet later	Kelak kita akan bertemu
The congress takes place in Jakarta this week	Kongres berlangsung di Jakarta minggu ini
The technology revolution changes human life	Revolusi teknologi mengubah kehidupan manusia
This quarter's financial report is important	Laporan keuangan kuartal ini penting
This product has high commercial value	Produk ini memiliki nilai komersial tinggi
Low radio signal frequency	Frekuensi sinyal radio rendah
He works in the product line	Dia bekerja di lini produk
The area is prone to natural disasters	Wilayah itu rawan bencana alam
The parliament is discussing a new law	Parlemen membahas undang-undang baru
The glass is transparent and clean	Kaca itu transparan dan bersih
I drink herbal medicine this morning	Saya minum jamu herbal pagi ini
The quantity of this item is limited	Kuantitas barang ini terbatas
The woman's breasts are beautiful	Payudara wanita itu indah
Cultural adaptation takes time	Adaptasi budaya memerlukan waktu
Local culture needs to be preserved	Kultur lokal perlu dilestarikan
The ship sails upstream	Kapal berlayar ke hulu sungai
Our house roof is leaking	Atap rumah kami bocor
That house is really big	Rumah itu gede banget
The new cabinet has been installed	Kabinet baru sudah terpasang
Stimulate our children's creativity	Rangsang kreativitas anak-anak kita
The scope of this work is quite broad	Lingkup pekerjaan ini cukup luas
The music sounds classical and beautiful	Musiknya terdengar klasik dan indah
We have to queue at the cashier	Kami harus antre di kasir
She looks sexy tonight	Dia terlihat seksi malam ini
This information is relevant to us	Informasi ini relevan untuk kita
Today feels really fun	Hari ini terasa asyik banget
You know that is true	Kamu tahu lho, itu benar
She showcases her artistic talent	Dia unjuk bakat seni
The education levels in Indonesia are important	Jenjang pendidikan di Indonesia penting
Microorganisms are important for health	Mikroorganisme penting untuk kesehatan
That memory is still clearly remembered	Memori itu masih jelas diingat
The stock of goods is out	Stok barang sudah habis
I feel pain in my back	Saya merasa nyeri di punggung
External resources are needed for this project	Sumber daya eksternal diperlukan proyek ini
He executed the penalty well	Dia mengeksekusi penalti dengan baik
The doctor is performing heart surgery today	Dokter melakukan bedah jantung hari ini
The portion of the food is quite large	Porsi makanannya cukup besar
The bridge looks sturdy	Jembatan itu tampak kokoh
The goalkeeper saved the goal	Kiper itu menyelamatkan gol
This is the right moment	Ini adalah momen yang tepat
The automotive industry continues to grow rapidly	Industri otomotif terus berkembang pesat
We will meet tomorrow	Kita akan bertemu esok
The water in this well is clean	Air di sumur ini bersih
Landslide blocked the main road	Tanah longsor menutup jalan utama
The road rehabilitation project starts this week	Proyek rehabilitasi jalan dimulai minggu ini
I paid the parking fine today	Saya membayar denda parkir hari ini
Data is displayed in a table	Data ditampilkan dalam tabel
The family's financial condition is deteriorating	Kondisi finansial keluarga memburuk
I like studying geography	Saya suka belajar geografi
I am writing a new paper	Saya sedang menulis makalah baru
Soak the rice before cooking	Rendam beras sebelum dimasak
I have several options	Saya punya beberapa opsi
This species is endangered	Spesies ini terancam punah
Sexually transmitted diseases need to be treated	Penyakit kelamin perlu diobati
He has a strong passion for art	Dia memiliki gairah seni tinggi
The dean gave a warm welcome	Dekan memberikan sambutan hangat
The river flows to the estuary	Sungai itu mengalir ke muara
My opinion is different from yours	Opini saya berbeda dengan kalian
This artwork is very original	Karya seni ini sangat orisinal
The fortress looks magnificent	Benteng itu terlihat megah
The rescue team is always on standby	Tim penyelamat selalu siaga
The male cat is aggressive	Kucing jantan itu agresif
The human race is diverse and unique	Ras manusia beragam dan unik
His love is sincere and always sincere	Cintanya tulus dan tulus selalu
He updated his profile on social media	Dia memperbarui profilnya di media sosial
The director is famous in the city	Sutradara itu terkenal di kota
He was fired from his job	Dia dipecat dari pekerjaannya
This project is the result of team collaboration	Proyek ini hasil kolaborasi tim
The football team uses a new formation	Tim sepak bola menggunakan formasi baru
Gambling can harm many people	Judi bisa merugikan banyak orang
Corporate policies need to be updated	Kebijakan korporat perlu diperbarui
The river water is starting to recede	Air sungai mulai surut
The universe is full of mysteries	Semesta penuh dengan misteri
Education is important for the future	Edukasi penting untuk masa depan
The water pump is broken again	Pompa airnya rusak lagi
Steam is coming out of the pot	Uap air keluar dari panci
That guy is my good friend	Cowok itu teman baikku
He likes diving in the sea	Dia suka selam di laut
The children are playing on the wall	Anak-anak bermain di tembok
The genie appeared at night	Jin itu muncul di malam.
His leg is swollen after falling	Kakinya bengkak setelah jatuh
This class is held regularly	Kelas ini diadakan secara reguler
He took a portrait of our family	Dia mengambil potret keluarga kami
They clashed on the highway	Mereka bentrok di jalan raya
The play is very attention-grabbing	Lakon itu sangat menarik perhatian
I do not like tobacco	Saya tidak suka tembakau
The food is high in calories	Makanan itu tinggi kalori
The declaration of independence is read today	Deklarasi kemerdekaan dibaca hari ini
Their age range is very different	Rentang usia mereka berbeda jauh
I bought a new LPG	Saya membeli elpiji baru
This issue requires a real solution	Masalah ini membutuhkan solusi riil
The female cat is cute	Kucing betina itu lucu
Tropical forests are full of diversity	Hutan tropis penuh keanekaragaman
She needs extra effort	Dia butuh usaha ekstra
This column contains important information	Kolom ini berisi informasi penting
I like playing chess	Saya suka bermain catur
My employer is kind	Majikan saya baik hati
The figure attracted the attention of many people	Figur itu menarik perhatian banyak orang
Discrimination must be eliminated immediately	Diskriminasi harus dihapuskan segera
The devil always tempts humans	Iblis selalu menggoda manusia
The body of this car is very cool	Bodi mobil ini sangat keren
Clean water filtration process	Proses filtrasi air bersih
Air pollution is becoming increasingly concerning	Polusi udara semakin mengkhawatirkan
Since the rain the air is cool	Semenjak hujan, udara sejuk
Imagination takes me to a new world	Imajinasi membawaku ke dunia baru
My diploma is ready	Ijazah saya sudah siap
The company is engaged in securities	Perusahaan itu bergerak di sekuritas
He holds the hammer tightly	Dia memegang palu dengan kuat
This road has just been asphalted	Jalan ini baru saja aspal
The illustration attracts the reader's attention	Ilustrasi itu menarik perhatian pembaca
Hit the ball into the goal	Hantam bola ke gawang
She sits in the corner of the room	Dia duduk di pojok ruangan
We set up the tent there	Kami mendirikan tenda di sana
The opposition criticizes the government's policy	Oposisi mengkritik kebijakan pemerintah
He is cheating with my friend	Dia selingkuh dengan sahabatku
The bullet penetrated the wall	Peluru itu menembus dinding
She is the new fashion icon	Dia adalah ikon fashion baru
The Earth's atmosphere supports life	Atmosfer bumi mendukung kehidupan
She walks in the long corridor	Dia berjalan di koridor panjang
We must protect the minority	Kita harus melindungi minoritas tersebut
We attended the wedding reception	Kami menghadiri resepsi pernikahan itu
Species evolution occurs gradually	Evolusi spesies terjadi secara bertahap
We are going to the reservoir tomorrow	Kami pergi ke waduk besok
We need good protection	Kami butuh proteksi yang baik
The children are noisy in the park	Anak-anak ribut di taman
She likes to buy new cosmetics	Dia suka membeli kosmetik baru
I am interested in astronomy	Saya tertarik pada astronomi
He is standing at the threshold	Dia berdiri di ambang pintu
This book is interesting fiction	Buku ini adalah fiksi menarik
Stir the batter until well combined	Aduk adonan sampai merata
The water tank needs to be cleaned	Tangki air perlu dibersihkan
I am going to the pharmacy near here	Saya pergi ke apotek dekat sini
I take the bus to school	Saya naik bis ke sekolah
He lives in that district	Dia tinggal di distrik itu
He won the trophy of the competition	Dia memenangkan trofi lomba itu
My account was blocked by the system	Akun saya diblokir oleh sistem
The monument stands majestically over there	Tugu itu berdiri megah di sana
The officers are patrolling tonight	Petugas melakukan patroli malam ini
He suffers from severe asthma	Dia menderita asma parah
This refrigerator is made of aluminum	Kulkas ini terbuat dari aluminium
The mystery has not been solved	Misteri itu belum terpecahkan
This clothing feels loose	Pakaian ini terasa longgar
Birds are flying in the swamp	Burung-burung terbang di rawa
The ship crosses the narrow strait	Kapal melintasi selat sempit
Shia has a different perspective	Syiah memiliki pandangan berbeda
He carries a wooden stick	Dia membawa tongkat kayu
The buffalo is eating grass	Kerbau itu sedang makan rumput
Guess the number I am thinking of	Tebak angka yang saya pikirkan
He persuaded his younger sibling to study	Dia bujuk adiknya untuk belajar
I drain the pool water	Aku kuras air kolam
Palm tree in the beautiful garden	Pohon palem di taman indah
The queen wears a beautiful crown	Ratu mengenakan mahkota indah
I like reading classic literature	Saya suka membaca literatur klasik
He stands on a high cliff	Dia berdiri di tebing tinggi
She has a mysterious smile	Dia memiliki senyuman misterius
This canal flows very swiftly	Kanal ini mengalir deras sekali
The wire is easy to shape	Kawat itu mudah dibentuk
The dog licked the ice cream	Anjing itu jilat es krim
The child screamed in fear	Anak itu jerit ketakutan
Verbs in that sentence are important	Verba dalam kalimat itu penting
He sleeps on the new bed	Dia tidur di ranjang baru
The party decoration looks beautiful	Dekorasi pesta terlihat indah
He fell into the ravine	Dia terjatuh ke jurang
Be careful with that thorn	Hati-hati dengan duri itu
Our ancestors' story is interesting	Kisah moyang kami menarik
Obesity can affect health	Obesitas dapat mempengaruhi kesehatan
This cooperative helps local farmers	Kooperasi ini membantu petani lokal
This application helps with road navigation	Aplikasi ini membantu navigasi jalan
The ball floats in the water	Bola itu apung di air
The gossip spreads quickly	Gosip itu menyebar cepat
The camel walks in the desert	Unta berjalan di padang pasir
Their reaction surprised everyone	Reaksi mereka mengejutkan semua orang
He writes with red ink	Dia menulis dengan tinta merah
She likes to do her makeup	Dia suka rias wajahnya
I am already full from eating	Saya sudah kenyang makan
He visits the new art gallery	Dia mengunjungi galeri seni baru
The children are playing with balloons	Anak-anak bermain dengan balon
The film crew is working hard	Kru film sedang bekerja keras
He arrived late to school	Dia datang telat ke sekolah
She bought a new perfume	Dia membeli parfum baru
I like watching cartoons	Saya suka menonton kartun
The sack is full of rice	Karung itu penuh beras
The fan is spinning slowly	Kipas angin berputar pelan
The proverb contains wisdom	Pepatah itu mengandung kebijaksanaan.
This furniture looks very elegant	Mebel ini terlihat sangat elegan
He entered the cabin	Dia masuk ke dalam kabin
She looks graceful while dancing	Dia terlihat anggun saat menari
He is waiting at the bus stop	Dia menunggu di halte bus
The design is very simple and elegant	Desainnya sangat simpel dan elegan
We will go to the bazaar	Kami akan pergi ke bazar
Beautiful twilight at the beach	Senja indah di pantai.
She squeezed the fruit gently	Dia remas buah itu lembut
The container is already full of goods	Kontainer itu sudah penuh barang
The race has finished well	Lomba sudah finis dengan baik
The eagle flies high in the sky	Elang terbang tinggi di langit
My family is Protestant	Keluargaku adalah penganut protestan
I am carrying a shopping basket	Saya membawa keranjang belanja
The children are playing on the sidewalk	Anak-anak bermain di trotoar
The fried rice tastes savory	Rasa nasi gorengnya gurih
The rhinoceros is almost extinct now	Badak itu hampir punah sekarang
The bull is grazing	Banteng itu sedang merumput
I like surfing at the beach	Saya suka selancar di pantai
The child has a cute belly button	Anak itu memiliki pusar lucu
The foam is soft and comfortable	Busa itu lembut dan nyaman
He is sleeping soundly on the sofa	Dia tidur lelap di sofa
I took a math quiz today	Saya mengikuti kuis matematika hari ini
I am auditioning for the theater today	Saya mengikuti audisi teater hari ini
He needs routine medication	Dia membutuhkan medikasi rutin
The stars in our galaxy	Bintang-bintang di galaksi kita
The Egyptian pyramids attract many tourists	Piramida Mesir menarik banyak wisatawan
This curry uses thick coconut milk	Kari ini menggunakan santan kental
The cat looks alpha	Kucing itu terlihat alfa
This cake is steamed	Kue ini dimasak dengan kukus
I have to work overtime tonight	Saya harus lembur malam ini
I like difficult puzzles	Saya suka teka-teki sulit
He walks on the gravel	Dia berjalan di atas kerikil
Weeds grow in my garden	Gulma tumbuh di kebun saya
The painting is on the canvas	Lukisan itu ada di kanvas
I like jackfruit	Saya suka buah nangka
She carries that red backpack	Dia membawa ransel merah itu
Collagen consumption is good for the skin	Konsumsi kolagen baik untuk kulit
She bought new lipstick	Dia membeli lipstik baru
I like to eat avocado	Saya suka makan alpukat
The Atlantic Ocean is very vast	Laut Atlantik sangat luas
The tractor is working in the field	Traktor itu bekerja di ladang
She is wearing a new vest	Dia mengenakan rompi baru
I keep the book in the locker	Saya simpan buku di loker
I am participating in the marathon this week	Saya ikut maraton minggu ini
He sneezed in class	Dia bersin di kelas
She is wearing new earrings	Dia memakai anting baru
He bought a new double burger	Dia membeli dobbel burger baru
He farted in class	Dia kentut di kelas
Casual clothes are suitable for relaxing	Pakaian kasual cocok untuk santai
This flower vase is very beautiful	Vas bunga ini sangat indah
I like to eat curry	Saya suka makan kari
I like chocolate pudding	Saya suka puding cokelat
I like to eat pears	Aku suka makan pir
The child wants to pee	Anak itu mau pipis
Children like to go to the circus	Anak-anak suka pergi sirkus
I like tapioca food	Saya suka makanan tapioka
He brings a new tennis racket	Dia membawa raket tenis baru
This cake is sprinkled with crispy sesame	Kue ini taburi wijen renyah
The zipper of the bag is broken again	Ritsleting tasnya rusak lagi
He is a great left-handed person	Dia seorang kidal yang hebat
I like playing new games	Saya suka bermain gim baru
I like to eat squid	Saya suka makan cumi-cumi
I like sweet raisins	Saya suka kismis manis
Smoke comes out of the chimney	Asap keluar dari cerobong
The children are learning a new alphabet	Anak-anak belajar alfabet baru
I like to eat raw radish	Saya suka makan lobak mentah
The ambulance siren sounds loud	Sirene ambulans terdengar nyaring
I am going up the escalator now	Saya naik eskalator sekarang
I like to eat omelette	Saya suka makan dadar
He went to the nightclub	Dia pergi ke kelab malam
Corona adorns the sky tonight	Korona menghiasi langit malam ini
The child is drawing with crayons	Anak itu menggambar dengan krayon
I like bagels with cream cheese	Saya suka bagel dengan krim keju
I enjoy whiskey tonight	Saya menikmati wiski malam ini
See you goodbye friends	Sampai jumpa, dadah teman-teman
He has great potential	Dia memiliki potensi besar
We need to practice more	Kita perlu praktik lebih banyak
The cat is very unfortunate	Kucing itu malang sekali
We all want to live prosperously	Kita semua ingin hidup sejahtera
The prosecutor leads the hearing today	Jaksa memimpin sidang hari ini
The price index of goods rose drastically	Indeks harga barang naik drastis
The trial will start tomorrow morning	Sidang akan dimulai besok pagi
Food availability must be maintained	Ketersediaan pangan harus dijaga
Educational aspects need to be considered	Aspek pendidikan perlu diperhatikan
This transaction is complete	Transaksi ini sudah selesai
I always uphold the principle of honesty	Saya selalu menjunjung prinsip kejujuran
We need to conduct regular evaluations	Kami perlu melakukan evaluasi rutin
She has a strong commitment	Dia memiliki komitmen yang kuat
There are indications of weather changes	Ada indikasi perubahan cuaca
The main components in this project	Komponen utama dalam proyek ini
Technology innovation changes the world	Inovasi teknologi mengubah dunia
The river current flows swiftly	Arus sungai mengalir deras
We must do charity every day	Kita harus beramal setiap hari
He is a competent teacher	Dia adalah guru yang kompeten
Psychology helps understand human behavior	Psikologi membantu memahami perilaku manusia
We need a better alternative	Kita butuh alternatif yang lebih baik
The noise can trigger stress	Kebisingan itu bisa picu stres
Work ethics need to be applied	Etika kerja perlu diterapkan
The bird migration process begins	Proses migrasi burung dimulai
He accepts criticism well	Dia menerima kritik dengan baik
Discipline is important for success	Disiplin penting untuk sukses
Plants need regular fertilizer	Tanaman butuh pupuk rutin
Implementation of the new policy is necessary	Implementasi kebijakan baru diperlukan
The children play in an orderly manner	Anak-anak bermain dengan tertib
The rector gave a speech at the event	Rektor memberikan sambutan di acara
I need legal consultation	Saya butuh konsultasi hukum
Young cadres are ready to act	Kader muda siap beraksi
I am learning a new math formula	Saya belajar rumus matematika baru
He accused me of stealing	Dia tuduh saya mencuri
Turn left at the intersection only	Belok ke simpang kiri saja
I remain optimistic about the future	Saya tetap optimis untuk masa depan
Our vision for the future	Visi kami untuk masa depan
Inflation affects people's purchasing power	Inflasi mempengaruhi daya beli masyarakat
I am looking for a new property	Saya mencari properti baru
This natural phenomenon is very interesting	Fenomena alam ini sangat menarik
Light penetrates through the window	Cahaya tembus melalui jendela
The process of cultural integration is going well	Proses integrasi budaya berjalan baik
The word of God is a guide to life	Firman Tuhan adalah petunjuk hidup
I appreciate your appreciation	Saya menghargai apresiasi Anda
Bureaucracy often slows down the process	Birokrasi sering memperlambat proses
The function of this tool is very important	Fungsi alat ini sangat penting
Criteria for selecting prospective employees	Kriteria pemilihan calon pegawai
Every element has its role	Setiap elemen memiliki perannya
I am looking for that important archive	Saya mencari arsip penting itu
The spirit always watches over us	Roh itu selalu mengawasi kita
The growth of technology is becoming increasingly rapid	Pertumbuhan teknologi semakin pesat
I bought new government bonds	Saya membeli obligasi pemerintah baru
Although it was raining we still went	Kendati hujan, kami tetap pergi
He is obedient to his teachings	Dia taat pada ajarannya
This number is even and good	Angka ini genap dan bagus
The company will recruit new employees	Perusahaan itu akan rekrut karyawan baru
This data is very accurate	Data ini sangat akurat
People's perceptions always differ	Persepsi orang berbeda-beda selalu
The composition of this song attracts attention	Komposisi lagu ini menarik perhatian
The discourse attracts the attention of many people	Wacana itu menarik perhatian banyak orang
I like studying biology	Saya suka belajar biologi
She is enthusiastic about participating in the competition	Dia antusias mengikuti lomba
He is a pious person	Dia adalah orang saleh
He plays a traditional musical instrument	Dia memainkan instrumen musik tradisional
Investment requires sufficient capital	Investasi membutuhkan kapital yang cukup
This ideology influences government policy	Ideologi ini mempengaruhi kebijakan pemerintah
We all understand the situation	Kita semua maklum situasinya
The party coalition won the election	Koalisi partai memenangkan pemilu
Social norms need to be respected	Norma masyarakat perlu dihormati
The team's performance improved rapidly	Performa tim meningkat pesat
We conducted field observations	Kami melakukan observasi lapangan
Their relationship is getting closer	Relasi antara mereka semakin erat
This city becomes more prosperous every year	Kota ini semakin makmur setiap tahun
Music creates beautiful harmony	Musik menciptakan harmoni yang indah
His facial expression is full of meaning	Ekspresi wajahnya penuh makna
The Indonesian league standings are updated today	Klasemen Liga Indonesia diperbarui hari ini
Inner peace is important	Ketenangan batin itu penting
The execution of the plan went smoothly	Eksekusi rencana berjalan lancar
Environmental conservation efforts are very important	Upaya konservasi lingkungan penting sekali
The spiritual activities at the church are taking place	Kegiatan rohani di gereja berlangsung
Our society must be tolerant	Masyarakat kita harus toleran
Each phase has its own challenges	Setiap fase memiliki tantangannya sendiri
My internet quota is exhausted	Kuota internet saya habis
Genetic engineering affects agriculture	Rekayasa genetik mempengaruhi pertanian
He is the best midfielder on the team	Dia adalah gelandang terbaik tim
Our aspirations must be realized	Aspirasi kita harus diwujudkan
Pour water into the glass	Tuang air ke dalam gelas
The land dispute is still ongoing	Sengketa tanah masih berlanjut
Mercy I did not mean that	Ampun, saya tidak bermaksud demikian
This accommodation is comfortable and clean	Akomodasi ini nyaman dan bersih
Our team creates good synergy	Tim kami menciptakan sinergi yang baik
Pornography can damage the morals of society	Pornografi dapat merusak moral masyarakat
The incident made us worried	Insiden itu membuat kami khawatir
The chickens need feed	Ayam-ayam itu butuh pakan
This food is hard to digest	Makanan ini sulit dicerna
He took the initiative to help	Dia mengambil inisiatif untuk membantu
Our prayer is for everyone amen	Doa kita semua, amin
Logic is important in debate	Logika itu penting dalam debat
She is working on a new thesis	Dia sedang menyusun tesis baru
This disease affects the body's nerves	Penyakit ini mempengaruhi saraf tubuh
His career prospects look promising	Prospek kariernya terlihat menjanjikan
The commander led the troops wisely	Panglima itu memimpin pasukan dengan bijak
The decision is very rational	Keputusan itu sangat rasional
The race car speeds around the circuit	Mobil balap melaju di sirkuit
The corpse was found in the river	Mayat itu ditemukan di sungai
The judge's verdict has been delivered	Vonis hakim sudah dijatuhkan
Digital transformation is changing traditional business	Transformasi digital mengubah bisnis tradisional
The child began to rebel	Anak itu mulai berontak
The car modification attracts attention	Modifikasi mobil itu menarik perhatian
Every test has its own wisdom	Setiap ujian ada hikmah tersendiri
The team conducted a quick evacuation	Tim melakukan evakuasi cepat
Government intervention is urgently needed	Intervensi pemerintah diperlukan segera
This book is the main reference	Buku ini adalah referensi utama
The decision has serious consequences	Keputusan itu punya konsekuensi berat
We conducted a flight simulation	Kami melakukan simulasi penerbangan
The national budget is experiencing a deficit this year	Anggaran negara mengalami defisit tahun ini
The child adoption process is going smoothly	Proses adopsi anak berjalan lancar
Diplomacy is important for peace	Diplomasi penting untuk perdamaian
Children are vulnerable to disease	Anak-anak rentan terhadap penyakit
The pillar of the building is very sturdy	Pilar bangunan itu kokoh sekali
The gross weight of this item is high	Berat bruto barang ini tinggi
Data transmission runs smoothly	Transmisi data berjalan lancar
The river flows downstream	Sungai mengalir ke hilir
Efficient company logistics management	Pengelolaan logistik perusahaan efisien
Everyone has a different perspective	Setiap orang punya perspektif berbeda
The legend is still alive	Legenda itu masih hidup
Oh friend let's go	Wahai sahabat, ayo kita pergi
Water flows through the hose	Air mengalir melalui selang
Pests are attacking our plants	Hama menyerang tanaman kita
The weight of this book is quite heavy	Bobot buku ini cukup berat
We are allies in the struggle	Kami adalah sekutu dalam perjuangan
This regime must change immediately	Rezim ini harus segera berubah
Hazardous gas emissions increased drastically	Emisi gas berbahaya meningkat drastis
Integrity is the key to success	Integritas adalah kunci keberhasilan.
He has repented from his mistakes	Dia sudah tobat dari kesalahan
I study with the new module	Saya belajar dengan modul baru
This house needs immediate renovation	Rumah ini butuh renovasi segera
The delegation arrived this morning	Delegasi itu tiba pagi ini
My shirt collar is folded	Kerah baju saya terlipat
The manufacturing industry is growing rapidly	Industri manufaktur berkembang pesat
Our family received a new blessing	Keluarga kami menerima berkah baru
The weather today is extreme	Cuaca hari ini ekstrem
Self-reflection is important for growth	Refleksi diri penting untuk pertumbuhan
I deposit money at the bank	Saya setor uang di bank
This project is funded by a grant	Proyek ini didanai oleh hibah
The bird colony flies together	Koloni burung itu terbang bersama
She gently scolded me	Dia tegur saya dengan lembut
The work atmosphere must be conducive	Suasana kerja harus kondusif
He visits his relatives in the village	Dia mengunjungi kerabatnya di desa
The midwife helps with childbirth well	Bidan membantu persalinan dengan baik
The team conducted an investigation into the case	Tim melakukan investigasi kasus tersebut
Fresh mint leaf extract	Ekstrak daun mint segar
Monetary policy needs to be reviewed	Kebijakan moneter perlu ditinjau
The controversy attracted public attention	Kontroversi itu menarik perhatian publik
The data conversion process is fast	Proses konversi data berlangsung cepat
The change is radical	Perubahan itu bersifat radikal
His attitude is aggressive when debating	Sikapnya agresif saat berdebat
I attended the lecture	Saya hadir di ceramah itu
He is conducting a new experiment	Dia melakukan eksperimen baru
The two cars are identical in shape	Kedua mobil itu identik bentuknya
I have made a hotel reservation	Saya sudah membuat reservasi hotel
His opinion remains neutral and objective	Pendapatnya tetap netral dan objektif
Secondary role in the movie	Peran sekunder dalam film itu
My debt is paid off	Utang saya sudah lunas
Animal classification is important	Klasifikasi hewan itu penting
We need a concrete solution now	Kita butuh solusi konkret sekarang
The project scheme is very interesting	Skema proyek ini sangat menarik
This job is permanent	Pekerjaan ini bersifat permanen
Employees receive fair compensation	Karyawan menerima kompensasi yang adil
The market share of this product has increased	Pangsa pasar produk ini meningkat
Public sentiment towards this issue	Sentimen masyarakat terhadap isu ini
I need emotional counseling	Saya butuh konseling emosional
The deed has been signed	Akta itu sudah ditandatangani
My ambition is to be successful	Ambisi saya adalah menjadi sukses
High cholesterol can be dangerous	Tinggi kolesterol bisa berbahaya
I bought a new t-shirt	Saya membeli kaos baru
Don't choose just any book	Jangan pilih sembarang buku
She studies while listening to music	Dia belajar sembari mendengarkan musik
The caliph leads the Muslim community	Khalifah memimpin umat Islam
The new policy has wide-ranging impacts	Kebijakan baru itu berimbas luas
Attach this important document	Lampir dokumen penting ini
Please filter this water	Tolong saring air ini
Visit the palace during the holiday	Kunjungi keraton saat liburan
Life is full of irony	Kehidupan penuh dengan ironi
The body's immune system needs to be maintained	Sistem imun tubuh perlu dijaga
The plan is very comprehensive and clear	Rencana itu sangat komprehensif dan jelas
The parameters of this research are important	Parameter penelitian ini penting
Fiscal policy needs to be strengthened	Kebijakan fiskal perlu diperkuat
This morning's sermon is very inspirational	Khotbah pagi ini sangat inspiratif
I want to eat pizza	Saya pengen makan pizza
We must uphold the dignity of the nation	Kita harus menjaga martabat bangsa
This policy causes social exclusion	Kebijakan ini menyebabkan eksklusi sosial
The foundation of this house is very strong	Fondasi rumah ini sangat kuat
We made a raft from bamboo	Kami membuat rakit dari bambu
He carves a wooden statue	Dia ukir patung kayu
He displays a photo on the wall	Dia pajang foto di dinding
He is sensitive to other people's feelings	Dia peka terhadap perasaan orang lain
He is holding a wooden cross	Dia memegang salib kayu
I live in that dormitory	Saya tinggal di asrama itu
Clean water supply is limited	Suplai air bersih terbatas
Solar radiation affects the weather	Radiasi matahari mempengaruhi cuaca
He is experiencing severe depression	Dia mengalami depresi berat
Guide me to the right path	Tuntun saya menuju jalan yang benar
That scenario is very interesting	Skenario itu sangat menarik
He cursed the action	Dia kutuk tindakan itu
The turmoil of emotions is difficult to control	Gejolak emosi sulit dikendalikan
He looks fit today	Dia terlihat bugar hari ini
We escort the event	Kami kawal acara tersebut
The process of protein synthesis occurs quickly	Proses sintesis protein berlangsung cepat
The decision has many implications	Keputusan itu memiliki banyak implikasi
My knee joint feels painful	Sendi lututku terasa sakit
I need money now	Saya butuh duit baru
The child is very spoiled now	Anak itu sangat manja sekarang
His thoughts are always logical and rational	Pikirannya selalu logis dan rasional
The weather change feels drastic	Perubahan cuaca terasa drastis
I like watching new series	Saya suka menonton serial baru
He is paralyzed after the accident	Dia lumpuh setelah kecelakaan
He uses a car jack	Dia menggunakan dongkrak mobil
This activity requires strict supervision	Kegiatan ini memerlukan supervisi ketat
That night felt very romantic	Malam itu terasa sangat romantis
I live in a boarding house near the campus	Saya tinggal di indekos dekat kampus
The interpretation of the poem is interesting	Interpretasi puisi itu menarik
The experience provided a new sensation	Pengalaman itu memberikan sensasi baru
Meteorology is important for agriculture	Ilmu meteorologi penting untuk pertanian
The duration of this film is quite long	Durasi film ini cukup panjang
This health problem is chronic	Masalah kesehatan ini kronis
The building looks magnificent	Bangunan itu terlihat megah
Listen to our conscience	Dengarkan suara nurani kita
The idea crossed my mind	Ide itu terlintas di benak
The myth has been proven wrong	Mitos itu sudah terbukti salah
The explanation is easy for the layman to understand	Penjelasan itu mudah dipahami awam
The image looks very abstract	Gambarnya terlihat sangat abstrak
I will pay for a new motorcycle in installments	Saya akan cicil motor baru
Rare animals need to be protected	Satwa langka perlu dilindungi
The orphaned child smiled	Anak yatim itu tersenyum
I like to drink sugarcane juice	Saya suka minum air tebu
The transition to the digital era is underway	Transisi menuju era digital berlangsung
The emperor leads the kingdom wisely	Kaisar memimpin kerajaan dengan bijak
Their dedication is worth emulating	Dedikasi mereka patut dicontoh
The child was kidnapped by a foreigner	Anak itu diculik orang asing
He saw a flash of light	Dia melihat kilas cahaya
The country's foreign exchange needs are increasing	Kebutuhan devisa negara meningkat
He is my ex-boyfriend	Dia adalah eks pacarku
Spray water on the plants	Semprotkan air pada tanaman
Insurance premiums increased this year	Premi asuransi meningkat tahun ini
Today is Sunday	Hari ini adalah hari ahad
The stain on the shirt is hard to remove	Noda di baju sulit hilang
Macroeconomic analysis is important now	Analisis makro ekonomi penting sekarang
The senate is discussing a new law	Senat sedang membahas undang-undang baru
We cannot forget that tragedy	Kita tidak bisa melupakan tragedi itu
He has a clever trick to win	Dia punya trik jitu untuk menang
He has an official driving license	Dia memiliki lisensi mengemudi resmi
Tin is used to make cans	Timah digunakan untuk membuat kaleng
He is looking for cassava starch	Dia mencari pati singkong
This office is only temporary	Kantor ini bersifat temporer saja
Acne appeared on my face	Jerawat muncul di wajahku
The history of our nation is very rich	Histori bangsa kita sangat kaya
The river water is starting to overflow now	Air sungai mulai luap sekarang
I bought a new bolster pillow	Saya membeli bantal guling baru
He walks in the narrow alley	Dia berjalan di gang sempit
I filled out the questionnaire	Saya mengisi kuesioner itu
The dress looks elegant and graceful	Gaun itu terlihat elegan dan anggun
Children like to climb trees	Anak-anak suka panjat pohon
He made a spontaneous decision	Dia membuat keputusan spontan
The company's reputation is good	Reputasi perusahaan itu baik
Truth conquers all lies	Kebenaran mengalahkan semua dusta
Environmentally friendly hydro energy	Energi hidro ramah lingkungan
This product has a 1-year warranty	Produk ini memiliki garansi 1 tahun
The thyroid gland affects metabolism	Kelenjar tiroid mempengaruhi metabolisme
The statue is made of bronze	Patung itu terbuat dari perunggu
He brings a spear for hunting	Dia membawa tombak untuk berburu
The bishop delivered an inspirational sermon	Uskup memberikan khotbah yang inspiratif
The textile industry is growing rapidly	Industri tekstil berkembang pesat
He uses a new electric drill	Dia menggunakan bor listrik baru
The tree grows tall vertically	Pohon itu tumbuh vertikal tinggi
This device makes our work easier	Peranti ini memudahkan pekerjaan kita
This design looks aesthetic and modern	Desain ini terlihat estetis dan modern
The water is clear like crystal	Airnya jernih seperti kristal
I received a dividend this year	Saya menerima dividen tahun ini
I am going to the consulate tomorrow	Saya pergi ke konsulat besok
She has a passive attitude	Dia memiliki sikap pasif
I like to roll paper	Aku suka gulung kertas
Cutting-edge technology makes life easier	Teknologi mutakhir memudahkan kehidupan
I donated to children	Saya memberikan donasi untuk anak-anak
So happy that he smiles	Saking senangnya dia tersenyum
Its water usage is very wasteful	Penggunaan airnya sangat boros
I take daily supplements	Saya mengonsumsi suplemen harian
Germs can cause serious illness	Kuman bisa menyebabkan penyakit berat
She is breastfeeding the baby with her nipple	Dia menyusui bayi dengan puting
He is our idol	Dia adalah idola kami
This alliance strengthens international cooperation	Aliansi ini memperkuat kerjasama internasional
Her acting is very impressive tonight	Aktingnya sangat mengesankan malam ini
The patient's condition is becoming more acute	Kondisi pasien semakin akut
This city needs sanitation improvements	Kota ini membutuhkan perbaikan sanitasi
The village head is holding a village meeting today	Kades mengadakan rapat desa hari ini
The scandal shook our society	Skandal itu mengguncang masyarakat kita
The progress of this project is quite good	Progres proyek ini cukup baik
The ball is round	Bola itu berbentuk bundar
He bought a new rattan chair	Dia membeli kursi rotan baru
The pen is full of poultry	Kandang itu penuh dengan unggas
The children are playing on the slope	Anak-anak bermain di lereng
She received a nomination for this year's award	Dia mendapat nominasi penghargaan tahun ini
The goat has long horns	Kambing itu memiliki tanduk panjang
I went to the shaman today	Saya pergi ke dukun hari ini
The company eventually went bankrupt	Perusahaan itu akhirnya bangkrut
We visited a beach resort	Kami mengunjungi resor pantai
Swipe the card for this payment	Gesek kartu untuk pembayaran ini
The child was abandoned on the street	Anak itu telantar di jalan
Farmers use pesticides for crops	Petani menggunakan pestisida untuk tanaman
Children swing in the park	Anak-anak ayun di taman
The system configuration needs to be updated	Konfigurasi sistem perlu diperbarui
The problem feels trivial	Masalah itu terasa sepele saja
The canary is singing beautifully	Burung kenari itu berkicau merdu
This condition causes several complications	Kondisi ini menyebabkan beberapa komplikasi
She is wearing a red mask	Dia mengenakan topeng berwarna merah
The widow lives alone now	Janda itu tinggal sendiri sekarang
The cavity in the wall of the house is leaking	Rongga di dinding rumah bocor
I send the letter now	Saya hantar surat itu sekarang
Coral reefs in beautiful seas	Terumbu karang di laut indah
The water is clear and transparent	Airnya bening dan jernih
He is a famous puppeteer	Dia adalah dalang terkenal
The result is only partial	Hasilnya hanya parsial saja
Vegetation in lush tropical forests	Vegetasi di hutan tropis subur
His character is quite captivating	Watak dia cukup menarik hati
The guerrilla forces attack tonight	Pasukan gerilya menyerang malam ini
I bought a new photo frame	Saya membeli bingkai foto baru
I ride a rickshaw to the market	Saya naik becak ke pasar
The crater looks amazing	Kawah itu terlihat menakjubkan
He was caught in a rat trap	Dia terkena perangkap tikus
The speed of the car is experiencing acceleration	Kecepatan mobil mengalami akselerasi
The colonel leads the troops	Kolonel itu memimpin pasukan
That book is a family heirloom	Buku itu adalah pusaka keluarga
Javanese script is rich in meaning	Aksara Jawa kaya akan makna
He feels frustrated with his job	Dia merasa frustrasi dengan pekerjaan
She is always pessimistic about the future	Dia selalu pesimis tentang masa depan
He took a shortcut	Dia mengambil jalan pintas
The car battery is dead	Aki mobilnya sudah habis
He estimates the price of the item	Dia taksir harga barang itu
The color of the shirt is clearly contrasting	Warna baju itu kontras jelas
We need to find a compromise now	Kita perlu mencari kompromi sekarang
The jasmine flower is fragrant in the garden	Bunga melati harum di taman
This paper is already fragile	Kertas ini sudah rapuh
He supports that decision	Dia sokong keputusan itu
My sleep is disturbed because of overlapping	Tidurku terganggu karena tindih
He is a good widower	Dia adalah duda yang baik
Data compression speeds up downloads	Kompresi data mempercepat pengunduhan
The oil refinery operates day and night	Kilang minyak beroperasi siang malam
The cat has a long tail	Kucing itu punya buntut panjang
Abortion is a sensitive topic	Aborsi adalah topik yang sensitif
This city has an ancient history	Kota ini memiliki sejarah purba
The population census is conducted every year	Sensus penduduk dilakukan setiap tahun
Reach for your dreams as high as the sky	Gapai mimpi setinggi langit
The caterpillar is crawling on the leaf	Ulat itu merayap di daun
The iron is already rusty	Besi itu sudah berkarat
The train carriage is full of passengers	Gerbong kereta penuh penumpang
The view here is fantastic	Pemandangan di sini fantastis
This room is messy again	Kamar ini berantak sekali lagi
This jelly tastes good	Jeli ini rasanya enak
Parasites live in the host's body	Parasit hidup di tubuh inang
I need a notary for the document	Saya butuh notaris untuk dokumen
The rotation of the Earth affects the weather	Rotasi bumi mempengaruhi cuaca
If it rains we will still go	Jikalau hujan, kita tetap pergi
He is the youngest child in the family	Dia adalah anak bungsu keluarga
The box is one cubic in size	Kotak itu berukuran satu kubik
People are crowding in the market	Orang-orang kerumun di pasar
I am writing a draft of the report	Saya sedang menulis draf laporan
That action is not ethical	Tindakan itu tidak etis
The direction of the qibla must be accurate	Arah kiblat harus tepat
He is a football fanatic	Dia adalah penggemar fanatik sepak bola
The bridge collapsed suddenly	Jembatan itu ambruk mendadak
He looks sluggish today	Dia terlihat lesu hari ini
We need a moment's pause	Kita butuh jeda sejenak
She needs a new vaccine injection	Dia membutuhkan injeksi vaksin baru
That style of dressing is very feminine	Gaya berpakaian itu sangat feminin
The audience enjoyed the performance	Audiens menikmati pertunjukan itu
The smell of the animal carcass is detected	Bangkai hewan itu tercium bau
I read the brochure	Saya membaca brosur itu
The express train arrives on time	Kereta ekspres tiba tepat waktu
This food tastes authentic and delicious	Makanan ini terasa autentik dan lezat
My account balance has decreased	Saldo rekening saya berkurang
The room temperature remains constant	Suhu ruangan tetap konstan
His views are quite moderate	Pandangan dia cukup moderat
This number is odd isn't it?	Nomor ini ganjil, bukan?
The children learn at the studio	Anak-anak belajar di sanggar
Tuberculosis can be contagious	Penyakit tuberkulosis bisa menular
The admiral leads the naval fleet	Laksamana memimpin armada laut
Whenever you come here	Bilamana kau datang ke sini
Education about contraception is very important	Pendidikan tentang kontrasepsi penting sekali
He has a strange obsession	Dia memiliki obsesi yang aneh
She is undergoing quarantine at home	Dia menjalani karantina di rumah
The story ends tragically	Kisahnya berakhir dengan tragis
His face is full of old wrinkles	Wajahnya penuh kerut tua
The collection of antique books is interesting	Koleksi buku antik itu menarik
The data is static only	Data tersebut bersifat statis saja
This book collection is complete and interesting	Koleksi buku ini komplet dan menarik
This dish is rich in natural spices	Masakan ini kaya rempah alami
Cloves are used in traditional cuisine	Cengkih digunakan dalam masakan tradisional
The atmosphere tonight is very quiet	Suasana malam ini sunyi sekali
Termites are damaging the wood of my house	Rayap merusak kayu rumahku
He is standing in the voting booth	Dia berdiri di bilik suara
The image looks blurry because of the pixels	Gambar itu terlihat buram karena piksel
The sparkle of stars adorns the night	Kilau bintang menghiasi malam
The singer's voice is hoarse	Suara penyanyi itu serak
This fabric is made of cotton	Kain ini terbuat dari kapas
Let's relax here	Mari kita rileks di sini
The sap of this tree is very sticky	Getah pohon ini lengket sekali
Lice in the child's hair	Kutu di rambut anak itu
I will go to the rally	Saya akan pergi ke reli
The quarterly report is ready	Laporan kuarter sudah siap
The show was truly spectacular	Pertunjukan itu benar-benar spektakuler
He speaks in the local dialect	Dia berbicara dalam dialek lokal
Gravity pulls objects downwards	Gravitasi menarik benda ke bawah
The bride looks beautiful	Mempelai wanita tampak cantik
His anger is difficult to control	Amarahnya sulit untuk dikendalikan
That fantasy makes me happy	Fantasi itu membuatku bahagia
He likes wrestling at school	Dia suka gulat di sekolah
Marines safeguard our sea security	Marinir menjaga keamanan laut kita
This need is very urgent	Kebutuhan ini sangat urgen
The company's assets increased this year	Aktiva perusahaan meningkat tahun ini
Skin pores need to be cared for	Pori-pori kulit perlu dirawat
I miss home and family	Saya kangen rumah dan keluarga
The book cover is blue	Sampul buku itu berwarna biru
The cargo has arrived at the port	Kargo sudah tiba di pelabuhan
Skin irritation due to allergy	Iritasi kulit akibat alergi
The television antenna is broken	Antena televisi itu rusak
The cake is very delicious	Kek itu enak sekali
The lines run parallel	Garis-garis itu berjalan paralel
He is our eldest child	Dia adalah anak sulung kami
Water flows in the ditch	Air mengalir di parit
He is indifferent to the problem	Dia acuh terhadap masalah itu
Stars adorn the night cosmos	Bintang-bintang menghiasi kosmos malam
Traffic on the road is heavily congested	Trafik di jalan macet berat
We need nickel for batteries	Kita butuh nikel untuk baterai
The space mission begins today	Misi ke antariksa dimulai hari ini
My pulse is racing	Nadi saya berdenyut kencang
This directory contains important information	Direktori ini berisi informasi penting
He slapped his classmate	Dia tampar teman sekelasnya
She is my stepchild	Dia anak tiri saya
We are installing a new partition	Kami memasang partisi baru
I have filled in that entry	Saya sudah mengisi entri itu
The tree is leaning to the left	Pohon itu condong ke kiri
The production process requires modern automation	Proses produksi membutuhkan automasi modern
She let out a soft sigh	Dia mengeluarkan desah pelan
The child has measles	Anak itu terkena campak
I like grilled fish side dishes	Saya suka lauk ikan bakar
This refrigerator needs to vacuum air	Kulkas ini perlu vakum udara
She suffers from a rare syndrome	Dia menderita sindrom langka
He is an amateur in photography	Dia seorang amatir dalam fotografi
The sound of crickets can be heard tonight	Suara jangkrik terdengar malam ini
The cart is full of vegetables	Gerobak itu penuh sayuran
The skull was found in the forest	Tengkorak itu ditemukan di hutan
She went to the new boutique	Dia pergi ke butik baru
She was shocked to hear the news	Dia syok mendengar berita itu
My child's report card is good this year	Rapor anakku bagus tahun ini
This film is very horror	Film ini sangat horor
The courier delivers the package today	Kurir mengantarkan paket hari ini
Wash your hands before eating	Basuh tangan sebelum makan
My family is close relatives	Keluarga saya adalah famili dekat
Iron ore is found here	Bijih besi ditemukan di sini
He gave a farewell wave	Dia memberi lambai perpisahan
The child is playing naked on the beach	Anak itu bermain bugil di pantai
Climate change has massive impacts	Perubahan iklim berdampak masif
She became hysterical when she heard the news	Dia menjadi histeris saat mendengar berita itu
The horse is standing on the straw	Kuda itu berdiri di jerami
Our mission is to help the community	Misi kami adalah membantu masyarakat
The mosque dome is very beautiful	Kubah masjid itu sangat indah
She draws a beautiful flower sketch	Dia menggambar sketsa bunga indah
He has a bald head	Dia memiliki kepala gundul
Wind turbines generate electrical energy	Turbin angin menghasilkan energi listrik
The forest felt dark and silent	Hutan itu terasa kelam dan sunyi
The child is an orphan	Anak itu adalah piatu
The deadline for submitting assignments is approaching	Tenggat waktu pengumpulan tugas mendekat
He rides a scooter to school	Dia naik skuter ke sekolah
The shirt looks dull and faded	Baju itu terlihat kusam dan pudar
He is still single until now	Dia masih lajang hingga sekarang
There is no time today	Kagak ada waktu hari ini
Turmeric is used in traditional cuisine	Kunyit digunakan dalam masakan tradisional
Climatology studies are important for agriculture	Studi klimatologi penting untuk pertanian
He follows the rhythm of the music	Dia mengikuti ritme musik
Debris from the building is scattered on the road	Puing bangunan berserakan di jalan
He also went to the market	Dia jua pergi ke pasar
The concert was accompanied by a large orchestra	Konser itu diiringi orkestra besar
The monorail connects two cities	Monorel menghubungkan dua kota.
He started to paddle the boat	Dia mulai kayuh perahu
He is annoyed with his attitude	Dia sebal dengan sikapnya
The idea is brilliant and innovative	Ide itu brilian dan inovatif
The safe is locked tight	Brankas itu terkunci rapat
My ear hurts after the concert	Kupingku sakit setelah konser
The sound of the bird is melodious	Suara burung itu merdu
First impressions are very important	Impresi pertama sangat penting
The fish has beautiful fins	Ikan itu memiliki sirip yang indah
I feel awkward when speaking	Saya merasa canggung saat berbicara
The donkey is eating grass	Keledai itu sedang makan rumput
He is still sane and healthy	Dia masih waras dan sehat
I like to eat oysters	Saya suka makan tiram
Morning dew clings to the leaves	Embun pagi menempel di daun
Moss grows on the wet wall	Lumut tumbuh di dinding basah
The council will be held next week	Konsili diadakan minggu depan
The pancreas produces the hormone insulin	Pankreas menghasilkan hormon insulin
Dinosaurs lived millions of years ago	Dinosaurus hidup jutaan tahun lalu
This device is compatible with the system	Perangkat ini kompatibel dengan sistem.
The fish has shiny scales	Ikan itu memiliki sisik berkilau
He uses steroids for recovery	Dia menggunakan steroid untuk pemulihan
She is still naive about life	Dia masih naif tentang hidup
The book is in the box	Buku itu ada di boks
I express my condolences	Saya menyampaikan rasa sungkawa
She reads an erotic novel	Dia membaca novel erotis
He fell and has a sore buttocks	Dia jatuh dan sakit bokong
The melody is very beautiful	Melodi itu sangat indah
He is lying dying at home	Dia terbaring sekarat di rumah
The quality of vegetables is influenced by carotene	Kualitas sayuran dipengaruhi karotena
This beef rib is very delicious	Iga sapi ini lezat banget
Catering for the wedding event	Katering untuk acara pernikahan
He hits the wood with an axe	Dia memukul kayu dengan kapak
I like morning aerobics	Saya suka aerobik pagi hari
I bought new tools	Saya membeli perkakas baru
The child is fussy when hungry	Anak itu rewel saat lapar
The cathedral looks magnificent	Katedral itu terlihat megah
My instinct always guides me right	Instingku selalu membimbingku benar
Our team's mascot is very cute	Maskot tim kami sangat lucu
He takes the paintbrush	Dia mengambil kuas cat
The green grasshopper jumps high	Belalang hijau melompat tinggi
The new millennium brings significant changes	Milenium baru membawa perubahan besar
I am experiencing constipation today	Aku mengalami sembelit hari ini
I like to ride in a jeep	Saya suka naik jip
I forgot the calculator at home	Saya lupa kalkulator di rumah
He speaks through the microphone	Dia berbicara melalui mikrofon
The car honked the horn	Mobil itu membunyikan klakson
I gargle with salt water	Saya kumur dengan air garam
She is wearing a new coat	Dia mengenakan mantel baru
He is going to the casino tonight	Dia pergi ke kasino malam ini
She has blonde hair	Dia punya rambut pirang
I live in this prefecture	Saya tinggal di prefektur ini
The taste of this food is very bland	Rasa makanan ini hambar banget
I take the tram to the office	Saya naik trem ke kantor
He makes imitation sculptures	Dia membuat patung imitasi
I like to plant herbs in the garden	Saya suka menanam herba di kebun
Dinner at the hotel buffet	Makan malam di prasmanan hotel
He plays with colorful cubes	Dia bermain dengan kubus warna-warni
I bought a new mattress	Saya membeli matras baru
He is very whiny today	Dia ini cengeng banget hari ini
Send a fax to the office tomorrow	Kirim faks ke kantor besok
She is wearing a red scarf	Dia mengenakan syal merah
We went on a picnic in the park	Kami pergi piknik di taman
She is wearing a new blouse	Dia mengenakan blus baru
I like to play bowling	Saya suka bermain boling
This shirt is made of wool	Kaus ini terbuat dari wol
He bought a new watch	Dia membeli arloji baru
This toilet needs to be cleaned	Kloset ini perlu dibersihkan
The coil works well	Koil itu berfungsi dengan baik
The squirrel jumped high	Tupai itu melompat tinggi
He carries a food tray	Dia membawa nampan makanan
The cholera outbreak spreads quickly	Wabah kolera menyebar cepat
This ashtray is full of cigarette butts	Asbak ini penuh dengan puntung
I like to eat turkey	Saya suka makan kalkun
I like jogging every morning	Saya suka joging setiap pagi
I bought a lottery ticket today	Saya membeli tiket lotre hari ini
This cake has a caramel flavor	Kue ini memiliki rasa karamel
She is wearing new pajamas	Dia memakai piama baru
This year is a leap year	Tahun ini adalah tahun kabisat
I bought a new ballpoint pen	Saya membeli bolpoin baru
I like macaroni and cheese	Saya suka makaroni keju
I like fresh apricots	Saya suka aprikot segar
He plays the cymbals cheerfully	Dia bermain simbal dengan ceria
We will barbecue in the park	Kami akan barbeku di taman
He plays the clarinet on stage	Dia bermain klarinet di panggung
Zombies are attacking the village tonight	Zombi menyerang desa malam ini
I like to eat pancakes	Saya suka makan panekuk
I am wearing a new sweater	Saya mengenakan sweter baru
The government provides food subsidies	Pemerintah memberikan subsidi pangan.
The price of commodities continues to rise	Harga komoditas terus meningkat
She aspires to be an entrepreneur	Dia bercita-cita jadi wirausaha
Dhuha prayer is the Sunnah of the Messenger	Shalat dhuha adalah sunah Rasul
The guidance of Allah always accompanies us	Hidayah Allah selalu menyertai kita
The province has broad autonomy	Provinsi itu memiliki otonomi luas
Cement is used to build houses	Semen digunakan untuk membangun rumah
The gospel teaches love and compassion	Injil mengajarkan kasih sayang
Students study at the pesantren every day	Santri belajar di pesantren setiap hari
The essence of life is full of meaning	Hakikat hidup penuh makna
Hormones affect mood	Hormon mempengaruhi suasana hati
The treasurer manages the school's finances	Bendahara mengelola keuangan sekolah
He is a trustworthy person	Dia adalah orang yang amanah
Nature exploration adds knowledge	Eksplorasi alam menambah pengetahuan
The company is making a new acquisition	Perusahaan melakukan akuisisi baru
He plays with the defender	Dia bermain dengan bek itu
The congregation gathers at the church	Jemaat berkumpul di gereja
The government provides tax incentives	Pemerintah memberikan insentif pajak
The fleet of ships sails to the port	Armada kapal berlayar ke pelabuhan
Market speculation has sharply increased	Spekulasi pasar meningkat tajam
He reported the rape case	Dia melaporkan kasus perkosa itu
The substance of this research is very important	Substansi penelitian ini sangat penting
Gene mutations can cause disease	Mutasi gen dapat menyebabkan penyakit
He was accused of slander	Dia dituduh melakukan fitnah
The oral exam takes place today	Ujian lisan berlangsung hari ini
Data accumulation shows an increasing trend	Kumulasi data menunjukkan tren meningkat
Sperm is important for human reproduction	Sperma penting untuk reproduksi manusia
Follow the health protocols properly	Ikuti protokol kesehatan dengan baik
The apocalypse can come at any time	Kiamat bisa datang kapan saja
The word 'book' is a noun	Kata 'buku' adalah nomina
Physical health needs to be maintained	Kesehatan jasmani perlu dijaga
Human cognition influences behavior	Kognisi manusia mempengaruhi perilaku
I need further clarification	Saya butuh klarifikasi lebih lanjut
The attribute is very important in the presentation	Atribut tersebut sangat penting dalam presentasi
The exploitation of natural resources continues	Eksploitasi sumber daya alam terus berlangsung
The mediation process went smoothly	Proses mediasi berjalan lancar
He cuts down a big tree	Dia tebang pohon besar
Irrigation systems increase crop yields	Sistem irigasi meningkatkan hasil panen
Metabolites play an important role in the body	Metabolit berperan penting dalam tubuh
We went on a pilgrimage to the grave	Kami pergi ziarah ke makam
He is a brave knight	Dia adalah kesatria yang berani
The children play freely in the park	Anak-anak bermain leluasa di taman
The military corps is training	Korps militer sedang berlatih
Theology helps to understand religion more deeply	Teologi membantu memahami agama lebih dalam
The lieutenant led the troops	Letnan itu memimpin pasukan
Water molecules are important for life	Molekul air penting untuk kehidupan
Opium can damage health	Candu dapat merusak kesehatan
Enzymes help the process of digesting food	Enzim membantu proses pencernaan makanan
I am updating my portfolio	Saya sedang memperbarui portofolio
He sells clothes retail	Dia jual baju eceran
The banner attracted the attention of the visitors	Spanduk itu menarik perhatian pengunjung
Their relationship is becoming more intimate	Hubungan mereka semakin intim
Education in this school is secular	Pendidikan di sekolah ini sekuler
He prostrated in the mosque	Dia sujud di masjid
The Indonesian contingent is ready to compete	Kontingen Indonesia siap bertanding
This case falls under civil law	Kasus ini termasuk hukum perdata
The stock value plummeted drastically	Nilai saham anjlok drastis
The data is empirical	Data tersebut bersifat empiris
Their love is eternal forever	Cinta mereka kekal selamanya
She reached a great orgasm	Dia mencapai orgasme yang hebat
The plenary meeting takes place today	Rapat pleno berlangsung hari ini
That artwork is very divine	Karya seni itu sangat ilahi
The foreign exchange rate increased drastically	Nilai valuta asing meningkat drastis
The judicial process is transparent	Proses yudisial berlangsung transparan
Environmental degradation is increasingly concerning	Degradasi lingkungan semakin mengkhawatirkan
The doctrine influenced government policy	Doktrin tersebut mempengaruhi kebijakan pemerintah
Our expectations are too high	Ekspektasi kita terlalu tinggi
The economy is experiencing a recession this year	Ekonomi mengalami resesi tahun ini
He went on a rampage because he was angry	Dia amuk karena marah
Franchise business is growing rapidly	Bisnis waralaba semakin berkembang
Reduction of greenhouse gas emissions	Reduksi emisi gas rumah kaca
Rainwater flows in the gutter	Air hujan mengalir di talang
He uses clever tactics	Dia menggunakan siasat cerdas
Please summarize this information	Tolong rangkum informasi ini
The charter was signed together	Piagam itu ditandatangani bersama
He revamped the old strategy	Dia rombak strategi lama
Polygamy is still a widespread debate	Poligami masih menjadi perdebatan luas
Market penetration is increasing this year	Penetrasi pasar semakin meningkat tahun ini
That he came late	Bahwasanya ia datang terlambat
The consortium is negotiating	Konsorsium itu sedang bernegosiasi
We need to check the inventory of items	Kami perlu mengecek inventaris barang
This tool must be sterile before use	Alat ini harus steril sebelum digunakan
Success tips in business	Kiat sukses dalam berbisnis
Amendments to the law are needed immediately	Amendemen undang-undang diperlukan segera
He can do magic	Dia bisa melakukan sulap
The feeling is manifested in actions	Perasaan itu manifes dalam tindakan
The shepherd takes care of his sheep	Gembala itu menjaga domba-dombanya
The detachment is ready to act	Detasemen itu siap beraksi
The learning process must be continuous	Proses belajar harus kontinu
We appreciate the cultural diversity of Indonesia	Kita menghargai diversitas budaya Indonesia
The fermentation process produces a healthy drink	Proses fermentasi menghasilkan minuman sehat
We need moderation in eating	Kita perlu moderasi dalam makan
Brain stimulation is important for learning	Stimulasi otak penting untuk belajar
This decision is crucial for us	Keputusan ini krusial bagi kita
The induction process affects the research results	Proses induksi mempengaruhi hasil penelitian
Our holiday destination is ready	Destinasi liburan kami sudah siap
Expedition to a remote island	Ekspedisi ke pulau terpencil
The bird catches small prey	Burung itu menangkap mangsa kecil
He has extraordinary charisma	Dia memiliki karisma yang luar biasa
This nature reserve must be protected	Cagar alam ini harus dilindungi
He said dick	Dia bilang kontol
Worship is performed with devotion	Ibadat dilakukan dengan khusyuk
This cylinder contains clean water	Silinder ini berisi air bersih
He received a new mandate	Dia menerima mandat baru
Arteries carry blood to the heart	Arteri membawa darah ke jantung
The peacock is very beautiful	Merak itu sangat indah
The experience felt mystical	Pengalaman itu terasa mistik
The volcano experienced a major eruption	Gunung berapi mengalami erupsi besar
The clerk is preparing the documents	Panitera sedang mempersiapkan dokumen
Muscle contractions occur during exercise	Kontraksi otot terjadi saat berolahraga
We need to strengthen the maritime sector	Kita perlu memperkuat sektor maritim
Be careful with ticket scalpers	Hati-hati dengan calo tiket
The fugitive managed to escape	Buron itu berhasil melarikan diri
She is completing her dissertation	Dia sedang menyelesaikan disertasi
His body posture looks upright	Postur tubuhnya terlihat tegap
Miracles happen in the midst of difficulties	Mukjizat terjadi di tengah kesulitan
The narrative of the story captures attention	Narasi cerita itu menarik perhatian
Human body physiology is very interesting	Fisiologi tubuh manusia menarik sekali
Soursop is good for juice	Sirsak enak untuk jus
The ball bounces off the wall	Bola itu memantul ke dinding
Scrape off the old wall paint	Kikis cat dinding yang lama
He showed sincere empathy	Dia menunjukkan empati yang tulus
The glucose level in the blood is normal	Kadar glukosa dalam darah normal
My grandfather is an elderly person	Kakekku adalah orang sepuh
I study anthropology at university	Saya belajar antropologi di universitas
The conciliation process went smoothly	Proses konsiliasi berjalan lancar
This aggregate is used for construction	Agregat ini digunakan untuk konstruksi
The police rescued the hostages there	Polisi menyelamatkan sandera di sana
We saw a beautiful landmark	Kami melihat tengara yang indah
The coup shook the government	Kudeta itu mengguncang pemerintahan
The hustle and bustle of the market is very lively	Hiruk pikuk pasar sangat ramai
The shackles bind our freedom	Belenggu itu mengikat kebebasan kita
He is a talented young scholar	Dia adalah cendekia muda berbakat
She is in the intermediate class	Dia berada di kelas madya
He has a pragmatic approach	Dia memiliki pendekatan yang pragmatis
The drug syndicate was arrested by the police	Sindikat narkoba ditangkap polisi
I read the biography of a famous figure	Saya membaca biografi tokoh terkenal
The chronology of the event is confusing	Kronologi kejadian itu membingungkan
Peat soil holds water	Tanah gambut menyimpan air.
He reads his grandfather's will	Dia membaca wasiat kakeknya
I am requesting an extension of time	Saya mengajukan ekstensi waktu
This analogy explains the concept	Analogi ini menjelaskan konsep tersebut
I met a new colleague	Saya bertemu kolega baru
They visited the old monastery	Mereka mengunjungi biara tua
Capital income increases this year	Pendapatan kapita meningkat tahun ini
It is important to maintain body hydration every day	Penting menjaga hidrasi tubuh setiap hari
This milk is already expired	Susu ini sudah kedaluwarsa
The nature of humans is to think	Kodrat manusia adalah berfikir
School policies must be inclusive	Kebijakan sekolah harus inklusif
The enemy invasion threatens peace	Invasi musuh mengancam perdamaian
The electoral impact of the election is significant	Dampak elektoral pemilu signifikan
The beautiful spectrum of rainbow colors	Spektrum warna pelangi indah
I am facing a big dilemma today	Aku menghadapi dilema besar hari ini
The presentation is conducted simultaneously in different rooms	Presentasi dilakukan secara simultan di ruangan berbeda
He inserted a secret message	Dia sisip pesan rahasia
The pledge strengthens the unity of the nation	Ikrar itu memperkuat persatuan bangsa
The bird shows territorial behavior	Burung itu menunjukkan sikap teritorial
The project budget ceiling has been established	Pagu anggaran proyek sudah ditetapkan
He often visits the house	Dia acap berkunjung ke rumah
His face looks quite friendly	Tampangnya terlihat cukup ramah
Preventive measures are important in health	Langkah preventif penting dalam kesehatan
Fusion reactors produce large energy	Reaktor fusi menghasilkan energi besar
Please leave a comment here	Tolong beri komen di sini
Betel leaves for cultural tradition	Daun sirih untuk tradisi budaya
The doctor performs an autopsy on the corpse	Dokter melakukan autopsi jenazah
The government strives to eradicate corruption	Pemerintah berusaha basmi korupsi
The exotic fruit attracts attention	Buah eksotis itu menarik perhatian
I like to eat spicy crackers	Aku suka makan kerupuk pedas
He uncovers the family's old secret	Dia singkap rahasia lama keluarga
I grate cheese for salad	Saya parut keju untuk salad
Ethanol is used as an alternative fuel	Etanol digunakan sebagai bahan bakar alternatif
The doctor examines the health of the male prostate	Dokter memeriksa kesehatan prostat pria
He was asked to sign a new contract	Dia diminta teken kontrak baru
We plant vegetables in the plot	Kami menanam sayur di petak
The company increases its owners equity	Perusahaan meningkatkan ekuitas pemiliknya
Measure the sugar according to the recipe	Takar gula sesuai resepnya
He joined a secret sect	Dia bergabung dengan sekte rahasia
The fire burns with hot charcoal	Api menyala dengan arang panas
The stall is full of many visitors	Lapak itu penuh pengunjung ramai
The bird is hiding in the bushes	Burung itu bersembunyi di semak
Lactate levels in the blood increase	Kadar laktat dalam darah meningkat
I want to try new food	Aku ingin jajal makanan baru
I bought a new console	Saya membeli konsol baru
I joined the community mailing list	Saya bergabung dengan milis komunitas
The use of plurals in sentences	Penggunaan jamak dalam kalimat
I feel tired today	Aku merasa penat hari ini
The prisoner receives remission today	Narapidana menerima remisi hari ini
The illness suddenly relapsed again	Penyakitnya tiba-tiba kambuh lagi
The solar eclipse is clearly visible tonight	Gerhana matahari terlihat jelas malam ini
He managed to hack the account	Dia berhasil retas akun itu
They are urging a boycott of foreign products	Mereka mengajak boikot produk asing
The child eats eagerly	Anak itu makan dengan lahap
He is indeed a badminton champion	Dia memang jawara bulu tangkis
The color of the shirt is starting to fade	Warna baju itu mulai luntur
I know the ins and outs well	Aku tahu seluk-beluknya baik
The young generation must innovate	Generasi belia harus berinovasi
The doctor diagnosed cataracts in the eye	Dokter mendiagnosis katarak mata
A thin membrane covers the lake	Selaput tipis menutupi danau
The bird flew from the cage	Burung itu terbang dari sangkar
Human anatomy is studied on campus	Anatomi manusia dipelajari di kampus
The decision is absolute	Keputusan itu bersifat absolut
The instruction is quite explicit and clear	Instruksi itu cukup eksplisit dan jelas
Big changes occur in a decade	Perubahan besar terjadi dalam dasawarsa
I make cake from sago	Saya membuat kue dari sagu
The coastal reclamation project has started	Proyek reklamasi pantai dimulai
The torque of this car engine is high	Torsi mesin mobil ini tinggi
The company chooses arbitration for dispute resolution	Perusahaan memilih arbitrase untuk penyelesaian sengketa
The company hierarchy influences work decisions	Hierarki perusahaan memengaruhi keputusan kerja
The locomotive pulls the passenger carriages	Lokomotif menarik gerbong penumpang
The little bird perched on the branch	Burung kecil hinggap di dahan
Intuition guides important decisions	Intuisi membimbing keputusan penting
Heat conduction occurs through metal	Konduksi panas terjadi melalui logam
I am learning to make warm knitting	Aku belajar membuat rajut hangat
He often complains about work	Dia sering komplain tentang pekerjaan
I dip bread into tea	Aku celup roti ke teh
I see cells with a microscope	Saya melihat sel dengan mikroskop
The prophecy made everyone surprised	Nubuat itu membuat semua terkejut
Rose petals are pink	Kelopak mawar berwarna merah muda
He writes an essay about education	Dia menulis esai tentang pendidikan
The horse needs a strong bridle	Kuda itu butuh kekang kuat
The exterior design of the house is attractive	Desain eksterior rumah itu menarik
I will edit this article	Aku akan menyunting artikel ini
The old cannon is still standing	Meriam tua itu masih berdiri
The evening sky is gray	Langit sore berwarna kelabu
He likes to do hand embroidery	Dia suka membuat sulam tangan
Bus route to the city center	Trayek bus menuju pusat kota
His philosophy of life is full of meaning	Falsafah hidupnya penuh makna
The carpenter uses a sharp chisel	Tukang kayu memakai pahat tajam
Don't forget to rinse your hair	Jangan lupa bilas rambutmu
The matrix contains unique numbers	Matriks tersebut berisi angka unik
The vein is clearly visible on the hand	Vena itu terlihat jelas di tangan
He remained silent and mute	Dia diam dan bisu terus
Persuasion techniques influence customer decisions	Teknik persuasi memengaruhi keputusan pelanggan
The fruit maturation process occurs naturally	Proses maturasi buah berlangsung alami
Every creature will surely face death	Setiap makhluk pasti menghadapi ajal
A motorcycle convoy passes through the city tonight	Konvoi motor melintasi kota malam ini
I want to travel to Bali	Aku ingin lancong ke Bali
He pronounced the triple divorce	Dia mengucapkan talak tiga
The electrical substation is severely damaged	Gardu listrik itu rusak parah
The cat scratches with its claws	Kucing itu menggores dengan cakar
Room ventilation needs to be improved	Ventilasi ruangan perlu diperbaiki
The wedding ceremony proceeded solemnly	Seremoni pernikahan berlangsung khidmat
Her face is beautiful like an angel	Wajahnya cantik seperti bidadari
The knife is sharp and pointed	Pisau itu tajam dan runcing
The disease is endemic in the area	Penyakit itu bersifat endemi di daerah tersebut
I like making funny rhymes	Aku suka membuat pantun lucu
The wedding dowry must be prepared	Mahar pernikahan harus dipersiapkan
The ancient statue attracts attention	Arca kuno itu menarik perhatian
The mountain landscape looks beautiful	Lanskap pegunungan terlihat indah
Good faith is important in work	Iktikad baik penting dalam kerja
This chart explains the work process	Bagan ini menjelaskan proses kerja
Bile helps digest fat	Empedu membantu pencernaan lemak
Discussing that topic is considered taboo	Membahas topik itu dianggap tabu
We plan to cruise next week	Kami berencana pesiar minggu depan
The government is striving to eradicate prostitution	Pemerintah berupaya memberantas prostitusi
Arabic calligraphy looks beautiful	Kaligrafi Arab terlihat indah
Comparison of the prices of this product is important	Komparasi harga produk ini penting
Assessment is needed for performance evaluation	Asesmen diperlukan untuk evaluasi kinerja
The president finally had to step down	Presiden itu akhirnya harus lengser
This device is quite reliable in operation	Perangkat ini cukup reliabel dalam operasi
The graph curve shows a sharp increase	Kurva grafik menunjukkan peningkatan tajam
The project cost calculation is complete	Kalkulasi biaya proyek sudah selesai
The battalion is ready to fight	Batalion itu siap bertempur
My gums feel very painful	Gusi saya terasa sakit sekali
I bought new powder today	Aku membeli bedak baru hari ini
Data is stored with strong encryption	Data disimpan dengan enkripsi kuat
She always looks fashionable every day	Dia selalu tampil modis setiap hari
The surface of the stone is concave	Batu itu permukaannya cekung
The vector indicates the direction of motion	Vektor itu menunjukkan arah gerak
The movie reaches an exciting climax	Film itu mencapai klimaks mendebarkan
The torch is lit in the dark night	Obor menyala di malam gelap
The dictator oppresses his people	Diktator itu menindas rakyatnya
His smile looks very cynical	Senyumnya terlihat sangat sinis
The ice cream cone is delicious	Kerucut es krim itu lezat
Introspection time is important for us	Waktu introspeksi penting bagi kita
My alma mater is the University of Indonesia	Almamaterku adalah Universitas Indonesia
My heart melts seeing you sad	Hatiku luluh melihatmu sedih
That snapper is big	Ikan kakap itu besar
The expert team conducts temple restoration	Tim ahli melakukan restorasi candi
My hand is injured because of the clutch	Tangan saya terluka karena kopling
Catalysts speed up chemical reactions	Katalis mempercepat reaksi kimia
The title of the book is interesting	Titel buku itu menarik
The paint on the wall notes is starting to peel	Catatan cat dinding mulai kelupas
The extradition process takes a long time	Proses ekstradisi memakan waktu lama
The shirt has a hole at the elbow	Kaosnya bolong di siku
The police conducted intensive interrogation of the victim	Polisi melakukan interogasi intensif korban
The car looks very old fashioned	Mobil itu terlihat lawas banget
His forehead furrowed as a sign of confusion	Keningnya berkerut tanda bingung
Generic medicine is more affordable in price	Obat generik lebih terjangkau harga
The ringing phone woke me up	Dering telepon membuatku terbangun
The pomegranate is ripe red	Buah delima itu merah matang
He tried to break down the door	Dia mencoba untuk dobrak pintu
Weather anomalies cause flooding	Anomali cuaca menyebabkan banjir
The car suddenly changed lanes	Mobil itu pindah lajur tiba-tiba
The peace pact was signed by both parties	Pakta damai diteken kedua pihak
The sun sets on the horizon	Matahari terbenam di cakrawala
Nutmeg trees grow in the garden	Pohon pala tumbuh di kebun
User preferences influence design	Preferensi pengguna mempengaruhi desain
The child suffers from goiter	Anak itu menderita gondok
The work feels monotonous all the time	Pekerjaan itu terasa monoton terus
Ancient artifacts were found at the site	Artefak kuno ditemukan di situs
Your idea is really crazy	Ide kamu benar-benar edan banget
Inflammation causes severe pain	Inflamasi menyebabkan nyeri hebat
He rose to the top of the class rankings	Dia naik rangking juara kelas
The bolt must be tightened first	Baut itu harus dikencangkan dulu
He follows the latest fashion trends	Dia mengikuti tren fesyen terbaru
I see stars with a telescope	Saya melihat bintang dengan teleskop
Customer testimonials are very helpful for decisions	Testimoni pelanggan sangat membantu keputusan
Natural fragrant sandalwood oil	Minyak cendana harum alami
The singer is very famous	Penyanyi itu sangat masyhur
The child is hiding under the table	Anak itu bersembunyi di kolong meja
Whales are large marine mammals	Paus adalah mamalia laut besar
The soldiers threw grenades at the enemy	Tentara melempar granat ke musuh
The sound of pain moans is heard softly	Rintih kesakitan terdengar pelan
His hard work has paid off	Jerih payahnya membuahkan hasil
The rice has black crust	Nasi itu ada kerak hitam
The soldier guards the stubborn border	Serdadu itu menjaga perbatasan keras kepala
He was just promoted to non-commissioned officer rank	Dia baru naik pangkat bintara
Chemical residues must be disposed of correctly	Residu kimia harus dibuang benar
His her belly is starting to look bloated	Perutnya mulai terlihat buncit
Optical illusions deceive our eyes	Ilusi optik menipu mata kita
The floor of the house is made of marble	Lantai rumahnya terbuat dari marmer
Fresh milkfish at the market	Ikan bandeng segar di pasar
This player has high caliber	Pemain ini punya kaliber tinggi
The ozone layer protects the earth	Lapisan ozon melindungi bumi
The garment factory is very large	Pabrik garmen itu besar sekali
His attitude is easily changeable unstable	Sikapnya mudah berubah labil
He ignored the teacher's warning	Dia gubris peringatan guru
The child sits in the hut	Anak itu duduk di gubuk
Please stamp this document	Tolong beri stempel dokumen ini
This bread is very stale	Roti ini sudah basi banget
The cartel controls the oil market	Kartel itu menguasai pasar minyak
The cat has striped fur	Kucing itu punya bulu belang
He carries the sharp machete	Dia membawa golok tajam itu
Numerical data helps analysis	Data numerik membantu analisis
Typical rainy season weather	Cuaca tipikal musim hujan
The symposium discusses the latest technological innovations	Simposium membahas inovasi teknologi terbaru
The supremacy of technology changes the world	Supremasi teknologi mengubah dunia
The beach experienced severe abrasion	Pantai itu mengalami abrasi parah
The technology looks primitive	Teknologi itu terlihat primitif
the necklace strand came undone	untai kalung itu terlepas
The road to the steep summit	Jalan menuju puncak terjal
The child is holding a wooden bow	Anak itu memegang busur kayu
The money suddenly disappeared yesterday	Uangnya tiba-tiba raib kemarin
Nicotine causes cigarette addiction	Nikotin menyebabkan ketergantungan rokok
This tool works with high precision	Alat ini bekerja dengan presisi tinggi
The frog jumps in the morning pond	Kodok melompat di kolam pagi
thirst after running long	dahaga setelah berlari panjang
The child is squatting near the door	Anak itu duduk jongkok dekat pintu
The film has a new sequel	Film itu memiliki sekuel baru
My legs feel sore after walking	Kaki saya terasa pegal setelah berjalan
Her hair is black and curly	Rambutnya hitam dan keriting
The child is going through puberty	Anak itu sedang mengalami puber
These chips taste very crispy	Keripik ini terasa sangat renyah
The sodium content in salt is high	Kandungan natrium dalam garam tinggi
New incoming message notification	Notifikasi pesan masuk baru
We rent a luxury limousine	Kami sewa limosin mewah
The probability of winning the lottery is small	Probabilitas menang dalam lotre kecil
Police intercept suspicious vehicle	Polisi cegat kendaraan mencurigakan
The car is parked in the depot	Mobil itu diparkir di depo
The bird is looking for a new host	Burung itu mencari inang baru
Beetles fly in the flower garden	Kumbang terbang di taman bunga
seismic activity increased sharply	aktivitas seismik meningkat tajam
This bread feels chewy and delicious	Roti ini terasa kenyal dan lezat
We send an online petition	Kami mengirim petisi online
The sound of the bird is heard loudly	Suara burung terdengar nyaring
The company gives severance pay to employees	Perusahaan memberikan pesangon kepada karyawan
Organ transplantation saves lives	Transplantasi organ menyelamatkan nyawa
The president grants clemency to the prisoner	Presiden memberikan grasi kepada narapidana
Kitchen utensils are made of silicone	Peralatan dapur terbuat dari silikon
Earthquakes occur due to fault shifts	Gempa terjadi akibat pergeseran sesar
The doctors suggestion influences the patient	Sugesti dokter mempengaruhi pasien
We are going to the disco tonight	Kami pergi ke disko malam ini
His ribs feel painful	Tulang rusuknya terasa sakit
The ocean's treasure holds valuable riches	Karun laut menyimpan harta berharga
The merchant bought many spices	Saudagar itu membeli banyak rempah
The pine forest looks fresh green	Hutan pinus terlihat hijau segar
Generalization sometimes misleads understanding	Generalisasi terkadang menyesatkan pemahaman
The aide helps in military duties	Ajudan membantu dalam tugas militer
Virgin water from the high mountains	Air perawan dari pegunungan tinggi
He remains skeptical of the promise	Dia tetap skeptis terhadap janji itu
Please scan this document quickly	Tolong pindai dokumen ini cepat
The bird perched on the fig tree	Burung itu hinggap di ara
He looks naive and innocent	Dia terlihat lugu dan polos
the smell of sulfur from the active crater	bau belerang dari kawah aktif
The foreman supervises the field workers	Mandor mengawasi pekerja lapangan
Be careful with pickpockets in the market	Hati-hati dengan copet di pasar
He uses a race jockey	Dia memakai joki lomba balap
The air in the mountains is very cool	Udara di pegunungan sangat adem
The parking is tight against the wall	Parkirannya mepet di tembok
He reads the history encyclopedia every day	Dia membaca ensiklopedia sejarah setiap hari
The clan controlled the area	Klan itu menguasai wilayah tersebut
The man's style of dressing is masculine	Gaya berpakaian pria itu maskulin
The patient is treated in the main ward	Pasien dirawat di bangsal utama
The faction competed closely in the election	Faksi itu bersaing ketat dalam pemilu
The padlock locks the house door	Gembok itu mengunci pintu rumah
I have respect for you	Saya punya respek padamu
The comet passed by tonight	Komet itu melintas malam ini
Drizzle falls in the morning	Gerimis turun saat pagi hari
He is too greedy with his food	Dia terlalu tamak makanannya
Interruption occurs during the meeting	Interupsi terjadi saat rapat berlangsung
The property valuation process is running smoothly	Proses valuasi properti berjalan lancar
The paradox is he is afraid of success	Paradoksnya, dia takut sukses
The message was sent anonymously	Pesan itu dikirim secara anonim
I see a bird with binoculars	Aku melihat burung dengan teropong
He is angry because he is late for work	Dia berang karena terlambat kerja
He often experiences severe migraines	Dia sering mengalami migrain berat
He is indeed a very stingy person	Dia memang orang pelit banget
Thermal clothing is suitable for winter	Pakaian termal cocok untuk musim dingin
Plant spores spread through the air	Spora tumbuhan menyebar melalui udara
This bluetooth speaker is portable and lightweight	Speaker bluetooth ini portabel dan ringan
Yeast is needed to make bread	Ragi diperlukan untuk membuat roti
He submitted a new legal exception	Dia mengajukan eksepsi hukum baru
Ovulation usually occurs every month	Ovulasi biasanya terjadi setiap bulan
He was treated because of typhoid	Dia dirawat karena tifus
The clitoris is a sensitive part of a woman	Klitoris adalah bagian sensitif wanita
The bunch of bananas is ripe red	Tandan pisang itu matang merah
A coconut shell broke on the road	Tempurung kelapa pecah di jalan
Paper is made from cellulose fibers	Kertas terbuat dari serat selulosa
He handled the case wisely	Dia menangani kes dengan bijak
Pull the lever to open the door	Tarik tuas untuk membuka pintu
the bird is trapped behind the bars	burung terjebak di balik jeruji
The children play the tambourine together	Anak-anak bermain rebana bersama
This chicken broth is very delicious	Kaldu ayam ini enak banget
The child has a red rash	Anak itu terkena ruam merah
He hit with a hard head	Dia memukul dengan kepal keras
The wound is discharging white pus	Luka itu mengeluarkan nanah putih
His hair is full of dandruff	Rambutnya penuh dengan ketombe
Barge carries coal load	Tongkang membawa muatan batu bara
I carry a warm hot thermos	Aku membawa termo panas hangat
The ship anchor is firmly embedded	Jangkar kapal tertancap kuat
The old mortar is full of stories	Lesung tua itu penuh cerita
The plaster sticks to my wound	Plester menempel di lukaku
Game addiction affects productivity	Adiksi game memengaruhi produktivitas
His words come back like a boomerang	Kata-katanya seperti bumerang kembali
The car chassis is strong and light	Sasis mobil itu kuat dan ringan
The dog walked limping this morning	Anjing itu berjalan pincang pagi ini
The soldiers avoid landmines	Tentara menghindari ranjau darat
Grouper fish live in the sea	Ikan kerapu hidup di laut
Patchouli plants grow well	Tanaman nilam tumbuh subur
I cook fresh stir fried mustard greens	Saya memasak tumis sawi segar
Quail eggs are delicious to eat	Telur puyuh enak dimakan
It tastes sour like an orange	Rasanya masam seperti jeruk
Elderly people need attention	Orang jompo butuh perhatian
Red lanterns decorate the highway	Lampion merah menghiasi jalan raya
Methane gas comes from swamps	Gas metana berasal rawa
He speaks with a Javanese accent	Dia berbicara dengan logat Jawa
The room felt so silent	Ruang itu terasa begitu senyap
The causal relationship between stress and health	Hubungan kausal antara stres dan kesehatan
The land looks barren and dry	Lahan itu terlihat tandus dan kering
The firm opens a new branch	Firma itu membuka cabang baru
The natural stunning beauty of the lagoon	Keindahan laguna menakjubkan alami
He is wearing a pink badge	Dia memakai lencana merah muda
The man is wearing a white turban	Pria itu memakai serban putih
The shirt looks shabby and dull	Baju itu terlihat lusuh dan kusam
The German Chancellor attends the international conference	Kanselir Jerman menghadiri konferensi internasional
They always get along with family	Mereka selalu akur bersama keluarga
I like to eat meatball offal	Saya suka makan jeroan bakso
He kept making loud grumbles	Dia terus mengeluarkan gerutu keras
The old castle attracts attention	Kastel tua itu menarik perhatian
The children laugh watching the clown	Anak-anak tertawa melihat badut
The spring is strong and flexible	Pegas itu kuat dan lentur
He remains calm in facing problems	Dia tetap kalem menghadapi masalah
The spare tire is in the trunk	Ban serep ada di bagasi
The king receives tribute from his people	Raja menerima upeti rakyatnya
Taro grows in the backyard garden	Talas tumbuh di kebun belakang
Her face looks plump and fresh	Wajahnya terlihat montok dan segar
The gecko hides on the wall	Tokek bersembunyi di dinding
The sergeant leads the troops firmly	Sersan memimpin pasukan dengan tegas
The cardinal bird is bright red	Burung kardinal berwarna merah cerah
I bought phone credit at the counter	Saya membeli pulsa di konter
The mummy was found in the pyramid	Mumi itu ditemukan di piramida
The lantern lights up the night road	Lentera menerangi jalan malam
The kitchen floor uses new tiles	Lantai dapur memakai ubin baru
Boiled cassava is suitable for snacks	Ketela rebus cocok untuk cemilan
Farmers plant sorghum in the field	Petani menanam sorgum di ladang
The necklace is adorned with beautiful emeralds	Kalung itu berhiaskan zamrud indah
The executioner waited in the court that night	Algojo menunggu di pengadilan malam itu
He is pacing back and forth in the corridor	Dia mondar-mandir di koridor
His face looks gloomy today	Wajahnya tampak muram hari ini
Chicken meat must be finely minced	Daging ayam harus dicincang halus
He studies ballet every day	Dia belajar balet setiap hari
The doctor suggests using skin ointment	Dokter menyarankan pakai salep kulit
The fabric is decorated with beautiful lace	Kain itu dihiasi renda cantik
We live in a new condominium	Kami tinggal di kondominium baru
The doctor examines the condition of the patients spleen	Dokter memeriksa kondisi limpa pasien
His identity card turned out to be fake	Kartu identitasnya ternyata gadungan
Sleep comfortably with a new mosquito net	Tidur nyaman dengan kelambu baru
The campfire is warm at night	Api unggun hangat di malam
The cat has a spotted pattern	Kucing itu memiliki pola tutul
Water flows from the bathroom sink	Air mengalir dari wastafel kamar mandi
Rumors spread in the office	Desas-desus menyebar di kantor
They met in the small chapel	Mereka bertemu di kapel kecil
I bought a new pickup truck	Saya membeli mobil pikap baru
The film is a funny parody	Film itu adalah parodi lucu
Potassium is important for heart health	Potasium penting untuk kesehatan jantung
I study about constellations	Aku belajar tentang rasi bintang
The group formed a secret cult	Kelompok itu membentuk kultus rahasia
I want to treat you to dinner	Aku mau traktir makan malam
His actions are too reckless and dangerous	Tindakannya terlalu sembrono dan berbahaya
She is wearing thick black mascara	Dia memakai maskara hitam tebal
My niece/nephew is good at playing ball	Kemenakan saya pintar bermain bola
Beautiful coral reefs in the sea	Terumbu koral indah di laut
The duchy has a long history	Kadipaten itu memiliki sejarah panjang
The king called his palace concubine	Raja memanggil selir istananya
Please get that screwdriver for me	Tolong ambilkan obeng itu
Fish breathe through red gills	Ikan bernapas melalui insang merah
A curative approach is needed immediately	Pendekatan kuratif diperlukan segera
Fresh basil leaves for salad	Daun kemangi segar untuk lalap
jellyfish swim in the sea	ubur-ubur berenang di laut
Artificial lights illuminate the room	Lampu artifisial menerangi ruangan
The crew sat inside the cockpit	Kru duduk di dalam kokpit
The rings of Saturn look beautiful	Cincin Saturnus terlihat indah
The stork flies over the rice field	Bangau terbang di atas sawah
The conductor checks the passenger's ticket	Kondektur memeriksa tiket penumpang
The mechanic repairs the broken car	Montir itu memperbaiki mobil rusak
The cowboy rides the horse fast	Koboi itu menunggang kuda cepat
Please tighten that screw	Tolong kencangkan sekrup itu
The glacier is starting to melt rapidly	Gletser itu mulai mencair cepat
The color of that shirt looks tacky	Warna baju itu terlihat norak
The Milky Way galaxy is full of beautiful stars	Galaksi Bimasakti penuh bintang indah
I need a sharp razor blade now	Aku butuh silet tajam sekarang
Moths fly at night	Ngengat terbang di malam hari
Passengers are waiting on the platform	Penumpang menunggu di peron
The columnist wrote an interesting opinion	Kolumnis itu menulis opini menarik
The doctor gives morphine for pain	Dokter memberikan morfin untuk nyeri
The corporal leads the troops firmly	Kopral memimpin pasukan dengan tegas
Workers use dynamite for blasting	Pekerja menggunakan dinamit untuk peledakan
Passengers board the emergency lifeboat	Penumpang menaiki sekoci darurat
The violin quartet performed stunningly	Kuartet biola tampil memukau
Fireflies sparkle in the night	Kunang-kunang berkilauan di malam
The tablecloth is red	Taplak meja itu berwarna merah
Seagulls fly over the sea	Camar terbang di atas laut
The planet Mercury is closest to the sun	Planet Merkurius terdekat matahari
The pendant is made of gold	Liontin itu terbuat dari emas
I like eating fried dumplings	Saya suka makan pangsit goreng
Marijuana is illegal in many countries	Mariyuana ilegal di banyak negara
I added fresh coriander	Saya menambahkan ketumbar segar
Netizens are actively commenting on the latest news	Netizen ramai komentari berita terbaru
The taste of glutamate enhances the flavor of food	Rasa glutamat meningkatkan cita rasa makanan
The planet Neptune is blue	Planet Neptunus berwarna biru
The children are playing on the ship deck	Anak-anak bermain di geladak kapal
I like to drink cold lemonade	Aku suka minum limun dingin
The fish smells really rancid	Ikan itu baunya tengik banget
I give a beautiful bouquet of flowers	Aku memberi buket bunga indah
He plays the harmonica in the park	Dia bermain harmonika di taman
We celebrate with red champagne	Kami merayakan dengan sampanye merah
She bought some new tampons	Dia membeli beberapa tampon baru
Otters build small dams	Berang-berang membangun bendungan kecil
The creaking of the machine disturbs sleep	Derit mesin itu mengganggu tidur
The kettle contains boiling water	Cerek berisi air mendidih
The child is holding a red lollipop	Anak itu memegang lolipop merah
She is wearing long black stockings	Dia memakai stoking hitam panjang
That cat's meow is very cute	Kucing itu lucu sekali meongnya
I am using a new presentation template	Saya menggunakan templat presentasi baru
He bought an expensive bottle of brandy	Dia membeli botol brendi mahal
Hadith explains the teachings of the Prophet	Hadis menjelaskan ajaran Nabi
Thank God, today is sunny	Alhamdulillah, hari ini cerah
He received a revelation this morning	Dia menerima wahyu pagi ini
Noble morals shape a strong character	Akhlak mulia membentuk karakter kuat
The argument explains Islamic law	Dalil itu menjelaskan hukum Islam
A new paradigm changes the way of thinking	Paradigma baru mengubah cara berpikir
The company requires high liquid assets	Perusahaan membutuhkan aset likuid tinggi
Studying fiqh deepens the understanding of religion	Belajar fikih memperdalam pemahaman agama
Mutual fund investment is profitable for beginners	investasi reksa dana menguntungkan bagi pemula
The doctor examines the health of the fetus	Dokter memeriksa kesehatan janin
The issuer raised its stock price	Emiten itu naik harga sahamnya
Echelon two officials attend the meeting	Pejabat eselon dua hadir rapat
Endowment land for a new mosque	Tanah wakaf untuk masjid baru
Adultery is forbidden in Islam	Zina dilarang dalam agama Islam
He bought meth from the night market	Dia membeli sabu dari pasar malam
Regression analysis helps predict outcomes	Analisis regresi membantu prediksi hasil
Algorithms help solve complex problems	Algoritma membantu memecahkan masalah kompleks
The referee's whistle blew loudly	Peluit wasit berbunyi keras
The act of shirk is strictly prohibited	Perbuatan syirik dilarang keras
The city situation turned into anarchy	Situasi kota berubah menjadi anarki
The children play in the pavilion	Anak-anak bermain di pendopo
City drainage needs to be improved	Drainase kota perlu diperbaiki
Sweet dates for breaking the fast	Kurma manis untuk berbuka puasa
The horticulture sector is rapidly developing	Bidang hortikultura berkembang pesat
The body needs detox from toxins	Tubuh butuh detoks dari toksin
The garden uses natural compost fertilizer	Taman menggunakan pupuk kompos alami
The microbe causes a new disease	Mikrob itu menyebabkan penyakit baru
The Torah contains God's laws	Kitab Taurat berisi hukum Tuhan
Avoid transactions that involve usury	Hindari transaksi yang mengandung riba
The inscription was found in the temple	Prasasti itu ditemukan di candi
The parish holds a weekly mass together	Paroki mengadakan misa mingguan bersama
The meeting minutes have been distributed	Risalah rapat sudah dibagikan
The doctor found a cyst in the ovary	Dokter menemukan kista di ovarium
The association routinely holds meetings	Paguyuban itu rutin mengadakan pertemuan
This rubber is quite elastic and strong	Karet ini cukup elastis dan kuat
Disaster mitigation needs to be carried out immediately	Mitigasi bencana penting dilakukan segera
The army's capitulation happened quickly	Kapitulasi tentara terjadi cepat
Thunder rumbled in the night	Guntur menggelegar di malam hari
Erection problems require special attention	Masalah ereksi butuh perhatian khusus
His lust is difficult to control	Syahwatnya sulit untuk dikendalikan
The ejaculation process occurs naturally	Proses ejakulasi terjadi alami
Sediment deposits cover the river	Endapan sedimen menutupi sungai
Personnel manage employee administration	Personalia mengatur administrasi karyawan
This rubric helps in assessing assignments	Rubrik ini membantu penilaian tugas
The government will immediately carry out the ratification of the agreement	Pemerintah segera lakukan ratifikasi perjanjian
Infantry troops are ready to fight	Pasukan infanteri siap bertempur
He is capable of performing rapid hypnosis	Dia mampu melakukan hipnotis cepat
The song reminds of the past	Tembang itu mengingatkan masa lalu
The prevalence of diabetes increases every year	Prevalensi diabetes meningkat setiap tahun
The sound of the motorcycle exhaust is loud	Suara knalpot motor itu keras
His statement is full of contradictions	Pernyataannya penuh dengan kontradiksi
The virus elimination process is running smoothly	Proses eliminasi virus berjalan lancar
Aerospace technology continues to develop	Teknologi dirgantara terus berkembang
That song compilation is really cool	Kompilasi lagu itu keren banget
Collusion harms the interests of the people	Kolusi merugikan kepentingan rakyat
The benchmark of this project's success	Tolok ukur keberhasilan proyek ini
Pathogens cause infectious diseases	Patogen menyebabkan penyakit menular
The placenta plays an important role in pregnancy	Plasenta berperan penting dalam kehamilan
The incubation process of chicken eggs takes place	Proses inkubasi telur ayam berlangsung
Government repression against demonstrators increases	Represi pemerintah terhadap demonstran meningkat
Soil erosion threatens our agriculture	Erosi tanah mengancam pertanian kita
Cultural hegemony influences society	Hegemoni budaya mempengaruhi masyarakat
grip his/her hand tightly	cengkeram tangannya dengan erat
He gave the speech solemnly	Dia memberikan sambutan dengan khidmat
Discussion about theism attracts many people	Diskusi mengenai teisme menarik banyak orang
The thyroid gland regulates the body's metabolism	Kelenjar tiroid mengatur metabolisme tubuh
Product differentiation strategy is important	Strategi diferensiasi produk penting
The confrontation solves the problem	Konfrontasi itu memecahkan masalah
The society is divided into castes	Masyarakat itu terbagi dalam kasta
We pray at the temple every week	Kami berdoa di kelenteng setiap minggu
Sound distortion makes the recording bad	Distorsi suara membuat rekaman buruk
The university has high prestige	Universitas itu memiliki prestise tinggi
Sea cucumbers are sold in traditional markets	Teripang dijual di pasar tradisional
The echo of music is heard in the distance	Gaung musik terdengar di kejauhan
She got angry and shouted pussy	Dia marah dan teriak memek
The number of human chromosomes is forty-six	Jumlah kromosom manusia adalah empat puluh enam
Historical fragments were found at the site	Fragmen sejarah ditemukan di situs
His reflexes quickly avoid danger	Refleksnya cepat menghindari bahaya
The forest succession process occurs naturally	Proses suksesi hutan berjalan alami
The rhetoric of his speech is very impressive	Retorika pidatonya sangat memukau
Natural pigments provide bright colors	Pigmen alami memberikan warna cerah
The file duplication process runs smoothly	Proses duplikasi file berjalan lancar
The virus cluster continues to develop	Klaster virus itu terus berkembang
Employee remuneration must be fair	Remunerasi karyawan harus adil
The population appears homogeneous	Populasi itu terlihat homogen
The children participate in the scout jamboree	Anak-anak mengikuti jambore pramuka
The duke leads the kingdom wisely	Adipati memimpin kerajaan dengan bijak
The girl is cute and friendly	Cewe itu lucu dan ramah
Hormone secretion affects metabolism	Sekresi hormon mempengaruhi metabolisme
Ripe breadfruit on the tree	Buah sukun matang di pohon
This pillow is filled with kapok	Bantal ini diisi dengan kapuk
This T-shirt uses cool screen printing	T-shirt ini memakai sablon keren
Corrosion damages the iron structure of the building	Korosi merusak struktur besi bangunan
The patient was diagnosed with rheumatoid arthritis	Pasien didiagnosis dengan reumatoid arthritis
A holistic approach in education is necessary	Pendekatan holistik dalam pendidikan diperlukan
Acts of plagiarism must be avoided	Tindak plagiat harus dihindari
The topography of this area is quite diverse	Topografi daerah ini cukup beragam
Leprosy patients need special attention	Penderita kusta butuh perhatian khusus
It is important to maintain personal hygiene every day	Penting menjaga higiene pribadi setiap hari
My eyes keep blinking rapidly	Mata saya terus kedip cepat
The caravan arrived in the city	Kafilah itu tiba di kota
Knowledge has many benefits	Ilmu pengetahuan memiliki banyak faedah
The condition of the building is already dilapidated	Kondisi gedung itu sudah bobrok
The knight uses a strong shield	Ksatria menggunakan perisai kuat
Polymers are used in the manufacture of plastics	Polimer digunakan dalam pembuatan plastik
The conglomerate controls the market	Konglomerat itu menguasai pasar
Decisions are made based on consensus	Keputusan diambil berdasarkan mufakat
The company follows the latest legal statutes	Perusahaan mengikuti statuta hukum terbaru
The vocational program improves students' skills	Program vokasi meningkatkan keterampilan siswa
We are passing through this important stage	Kami melewati etape penting ini
That little child is adorable	Anak kecil itu bikin gemas
Fresh sprouts for today's salad	Kecambah segar untuk salad hari ini
The order of animals is unique in shape	Ordo hewan itu unik bentuknya
The ship's embarkation arrived at the port	Embarkasi kapal tiba di pelabuhan
The music arrangement is unique and interesting	Aransemen musiknya unik dan menarik
This bone marrow soup is very delicious	Sup sumsum ini lezat banget
The teacher distributes the new syllabus	Guru membagikan silabus baru
Their opinions are beginning to converge	Pendapat mereka mulai konvergen
The population in this city is heterogeneous	Populasi di kota ini heterogen
The substitution process in chemistry is important	Proses substitusi dalam kimia penting
Dissemination of information is important for education	Diseminasi informasi penting untuk edukasi
The dance movements are fluid and graceful	Gerakan tarian itu fluida dan anggun
Men's testosterone levels naturally decrease	Kadar testosteron pria menurun alami
He became a snatching victim last night	Dia menjadi korban jambret tadi malam
The proposition is quite clear in its meaning	Proposisi itu cukup jelas maknanya
Local convection makes cheap clothes	Konveksi lokal membuat baju murah
He is known as a wicked person	Dia dikenal sebagai orang fasik
The asset value experienced a sharp depreciation	Nilai aset mengalami depresiasi tajam
Please provide the synopsis of this book	Tolong berikan sinopsis buku ini
There is a tendency of climate change	Terdapat tendensi perubahan iklim
The feudal system governs Javanese society	Sistem feodal mengatur masyarakat Jawa
The premise of the story is really interesting	Premis cerita itu menarik banget
I snapped a photo of the beautiful scenery	Aku jepret foto pemandangan indah
The oral mucosa feels irritated	Mukosa mulut terasa iritasi
The contours of his face are clearly visible	Kontur wajahnya terlihat jelas
Oil prices have become very volatile	Harga minyak menjadi sangat volatil
The company opened a new branch	Syarikat itu membuka cabang baru
The teacher gives dictation every day	Guru memberikan dikte setiap hari
Gender parity is important in organizations	Paritas gender penting dalam organisasi
Glycerol is used in natural cosmetics	Gliserol digunakan dalam kosmetik alami
The kitchen floor is made of granite	Lantai dapur terbuat dari granit
The typology of ancient buildings attracts attention	Tipologi bangunan kuno menarik perhatian
His heart shrinks facing the exam	Hatinya ciut menghadapi ujian
The court decided to annul the contract	Pengadilan memutuskan untuk anulir kontrak tersebut
Bauxite mining in Kalimantan increases	Tambang bauksit di Kalimantan meningkat
He tried to bribe the security officer	Dia mencoba sogok petugas keamanan
The bird uses natural camouflage	Burung itu menggunakan kamuflase alami
Intrinsic motivation is important in learning	Motivasi intrinsik penting dalam belajar
Iodine is important for the body	Kebutuhan yodium penting untuk tubuh
The car dealer is very friendly	Diler mobil itu ramah sekali
Coffee contains natural stimulant substances	Kopi mengandung zat stimulan alami
The justification for that decision is unclear	Justifikasi keputusan itu kurang jelas
The yield of sugarcane sugar increased sharply	Rendemen gula tebu meningkat tajam
The antagonist character makes the story interesting	Karakter antagonis membuat cerita menarik
I brewed warm tea this morning	Aku seduh teh hangat pagi ini
My idea is stuck there	Ideku mentok di situ
He was diagnosed with epilepsy	Dia didiagnosis menderita epilepsi
The new members perform the oath of allegiance	Para anggota baru melakukan baiat
The specimen was taken from the forest	Spesimen itu diambil dari hutan
He is the incarnation of true courage	Dia adalah inkarnasi keberanian nyata
The tree was successfully grafted well	Pohon itu berhasil dicangkok dengan baik
The euphoria of victory filled the stadium that night	Euforia kemenangan memenuhi stadion malam itu
The choreography of the dance was mesmerizing	Koreografi tari itu memukau
He is a pioneer of new technology	Dia adalah pionir teknologi baru
The sulfate content in the water is high	Kandungan sulfat dalam air tinggi
The snail crawls on the wet leaf	Keong merayap di daun basah
We meet every Sabbath	Kami bertemu setiap sabat
My zodiac is Leo today	Zodiakku adalah Leo hari ini
This soil is rich in natural phosphate	Tanah ini kaya fosfat alami
This soil is rich in natural phosphorus	Tanah ini kaya fosfor alami
The action was driven by impulse	Tindakan itu didorong oleh impuls
The process of nutrient absorption in the intestine	Proses absorpsi nutrisi dalam usus
The vessel is made of clay	Bejana itu terbuat dari tanah
The difference in the results is very noticeable	Perbedaan hasilnya kentara sekali
The dichotomy between theory and practice	Dikotomi antara teori dan praktik
Ferns grow on the riverbank	Pakis tumbuh di tepi sungai
Water retention in the soil increases	Retensi air di tanah meningkat
The road in the village collapsed	Jalan di desa itu amblas
The poet writes beautiful poems	Pujangga itu menulis puisi indah
The struggle for women's emancipation advances	Perjuangan emansipasi wanita maju
The woman is wearing a black veil	Wanita itu mengenakan cadar hitam
Didactic approach in learning	Pendekatan didaktis dalam pembelajaran
I am bringing a small flashlight tonight	Saya membawa senter kecil malam ini
The caricature is funny and creative	Karikatur itu lucu dan kreatif
The implicit meaning in the poem	Makna implisit dalam puisi itu
He writes prose beautifully	Dia menulis prosa dengan indah
He experienced hallucinations after a high fever	Dia mengalami halusinasi setelah demam tinggi
The children like to dance together	Anak-anak suka joget bersama
Mahogany tree grows in the yard	Pohon mahoni tumbuh di halaman
The lion shows its sharp fangs	Singa menunjukkan taring tajamnya
The House of Representatives submitted an interpellation to the government	DPR mengajukan interpelasi pemerintah
He lifts the heavy hoe	Dia mengangkat cangkul berat
He prays for the Prophet's intercession	Dia memohon syafaat Nabi
He is unwilling to go there	Dia ogah pergi ke sana
His style of dressing is eccentric	Gaya berpakaian dia eksentrik
The road is muddy after the rain	Jalanan becek setelah hujan
The musician is good at improvising songs	Musisi itu pandai improvisasi lagu
The light switch is broken	Sakelar lampu itu rusak
The direction of scattering after the explosion occurs	Arah pencar setelah ledakan terjadi
The catfish lives in the river	Ikan patin hidup di sungai
He studies at the Catholic seminary	Dia belajar di seminari Katolik
The Pharaoh ruled ancient Egypt	Firaun memerintah Mesir kuno
The nitrate content in the water is high	Kandungan nitrat dalam air tinggi
We have to sort the documents	Kami harus sortir dokumen itu
His/her joke created a cheerful atmosphere	Selorohnya membuat suasana ceria
The curtains were just installed yesterday	Gorden baru dipasang kemarin
The door sounded a loud knock	Pintu itu terdengar ketok keras
The calm ripples on the lake	Riak air tenang di danau
We play dominoes with friends	Kami bermain domino bersama teman
The pottery is made by hand	Gerabah itu dibuat dengan tangan
The roar of the waves crashes against the beach	Deru ombak menghantam pantai
Big sale at the electronics store	Obral besar di toko elektronik
The victim experienced severe mutilation	Korban mengalami mutilasi parah
The traveler is looking for a place to rest	Musafir itu mencari tempat istirahat
The aviation industry continues to grow rapidly	Industri aviasi terus berkembang pesat
The fried anchovies are very crispy	Ikan teri goreng renyah banget
The statement is quite clear and firm	Statemen itu cukup jelas dan tegas
This case creates a new precedent	Kasus ini menciptakan preseden baru
He was imprisoned in jail	Dia dipenjara di bui
This soil contains high clay content	Tanah ini mengandung lempung tinggi
The king sits on the magnificent throne	Raja duduk di singgasana megah
The government grants the latest political amnesty	Pemerintah memberikan amnesti politik terbaru
That handmade craft is unique and beautiful	Kriya tangan itu unik dan indah
I regularly do weekly cupping therapy	Saya rutin melakukan bekam mingguan
He is indeed a government stooge	Dia memang antek pemerintah itu
The poem is full of beautiful metaphors	Puisi itu penuh metafora indah
He writes an interesting book review	Dia menulis resensi buku menarik
The award plaque is given directly	Plakat penghargaan diberikan langsung
The regime is known for being harshly fascist	Rezim itu terkenal fasis keras
I am filling out the registration form	Saya mengisi borang pendaftaran
They are doing a dress rehearsal today	Mereka melakukan gladi bersih hari ini
Pandan leaves are flat green	Daun pandan berwarna hijau pipih
The taste of this coffee is bitter	Rasa kopi ini terasa getir
Primates live in tropical forests	Primata hidup di hutan tropis
The butcher is acting tonight	Jagal itu beraksi malam ini
He plays the traditional Javanese drum	Dia memainkan kendang tradisional Jawa
His face has dark spots	Wajahnya ada flek hitam
He is famous for being narcissistic	Dia terkenal karena sifat narsis
He tries to bluff the opponent	Dia mencoba untuk gertak lawan
The doctor diagnosed early syphilis	Dokter mendiagnosis sifilis dini
The healer is an expert in traditional medicine	Tabib itu ahli pengobatan tradisional
The coachman skillfully controls the horse-drawn carriage	Kusir mengendalikan delman dengan cekatan
The child is tall and lanky	Anak itu tinggi dan jangkung
He was sentenced to stoning	Dia terkena hukuman rajam
The ball kept rolling downwards	Bola itu terus gelinding ke bawah
He feels a small pinch pain	Dia merasa sakit cubit kecil
Hotel occupancy increased sharply	Okupansi hotel meningkat tajam
That bundle of books is very thick	Bundel buku itu tebal sekali
The doctor performed the amputation of the patient's hand	Dokter melakukan amputasi tangan pasien
This poem uses beautiful rhyme	Puisi ini menggunakan rima indah
Take the dipper in the bathroom	Ambil gayung di kamar mandi
The graph is located in the second quadrant	Grafik terletak di kuadran dua
The airplane is parked in the large hangar	Pesawat diparkir di hanggar besar
The young filmmaker is very talented	Sineas muda itu berbakat besar
I studied algebra yesterday	Saya belajar aljabar kemarin
The regiment trains every day	Resimen itu berlatih setiap hari
Visits to his/her house are sporadic	Kunjungan ke rumahnya sporadis
The motion was rejected by the members	Mosi itu ditolak oleh anggota
The baby was born with a cleft lip	Bayi itu lahir dengan sumbing
The sun rises exactly at the equator	Matahari terbit tepat di ekuator
The car engine valve must be replaced	Klep mesin mobil harus diganti
He throws the dice	Dia melempar dadu itu
The cough is accompanied by thick phlegm	Batuknya disertai dahak tebal
Wise advice from the elders	Petuah bijak dari orang tua
The area of a square is the side squared	Luas persegi adalah sisi kuadrat
Corn harvest reaches three quintals	Jagung panen mencapai tiga kuintal
The car repair process proceeds quickly	Proses reparasi mobil berlangsung cepat
The agile mouse deer runs in the forest	Kancil lincah berlari di hutan
He is cursed by the world	Dia terkena laknat dunia
The children enjoy popcorn	Anak-anak menikmati berondong jagung
Proverbs teach wisdom	Amsal itu mengajarkan kebijaksanaan
This clause explains its meaning	Klausa ini menjelaskan maksudnya
The introduction of the new product successfully attracted customers	Introduksi produk baru berhasil menarik pelanggan
The work is included in the literary canon	Karya itu termasuk dalam kanon sastra
Child custody rights in custody	Hak asuh anak dalam kustodi
Affirmations help boost self-confidence	Afirmasi membantu meningkatkan kepercayaan diri
Grilled fish with spicy shrimp paste	Ikan bakar dengan terasi pedas
The bread is too burnt today	Roti itu terlalu gosong hari ini
Arabica coffee tastes smoother	Kopi arabika terasa lebih halus
The radiology specialist doctor is practicing	Dokter spesialis radiologi berpraktik
The botany class starts this morning	Kelas botani dimulai pagi ini
The child's temperament is unique	Temperamen anak itu unik
The police put handcuffs on the suspect's hands	Polisi memasang borgol di tangan tersangka
The president is suspected of protecting cronies	Presiden diduga melindungi kroni
He was accused of committing sodomy	Dia dituduh melakukan sodomi
Parents believe in superstitions	Orang tua percaya takhayul itu
The animal handler is very skilled	Pawang hewan itu sangat ahli
The cliffs there are very rocky	Tebing di sana sangat cadas
Algae grow in clean lakes	Ganggang tumbuh di danau bersih
The artillery troops attacked that night	Pasukan artileri menyerang malam itu
He was diagnosed with mild schizophrenia	Dia didiagnosis skizofrenia ringan
He avoids the habit of masturbation	Dia menghindari kebiasaan onani
The light went out because of an electrical short circuit	Lampu mati karena korsleting listrik
The wooden peg is strong in holding	Pasak kayu itu kuat menahan
I use sandpaper made of wood	Saya menggunakan ampelas kayu
Incense spreads a fragrant aroma	Dupa menyebarkan aroma harum
That jade necklace is very beautiful	Kalung giok itu indah banget
Her face shape is somewhat oval	Bentuk wajahnya agak lonjong
The child plays the xylophone skillfully	Anak itu memainkan gambang dengan mahir
The flower buds are beginning to bloom	Kuncup bunga mulai bermekaran
Her skin is red because of eczema	Kulitnya merah karena eksem
The bag compartment contains important documents	Kompartemen tas berisi dokumen penting
I take water from the jug	Aku mengambil air dari kendi
The officer carried the victim with a stretcher	Petugas membawa korban dengan tandu
The monk lives in the monastery	Rahib itu tinggal di biara
Dim light creates a warm atmosphere	lampu remang membuat suasana hangat
The salinity of seawater has increased sharply	Salinitas air laut meningkat tajam
Eating etiquette is important in culture	Etiket makan penting dalam budaya
Arithmetic lessons are quite interesting	Pelajaran aritmetika cukup menarik
I eat with new chopsticks	Saya makan dengan sumpit baru
These chips taste very crispy	Keripik ini terasa garing banget
this gold is genuine and pure	emas ini asli dan tulen
He behaves like a psychopath	Dia berperilaku seperti psikopat
The child is playing marbles excitingly	Anak itu bermain kelereng seru
The wave amplitude increases sharply	Amplitudo gelombang meningkat tajam
The children are playing hide and seek in the park	Anak-anak bermain umpet di taman
The tycoon leads a big business	Taipan itu memimpin bisnis besar
The old clock's pendulum swings	Bandul jam tua itu berayun
The child is holding a long pole	Anak itu memegang galah panjang
Cyanide poison is dangerous for humans	Racun sianida berbahaya bagi manusia
The classroom feels stuffy this morning	Ruang kelas terasa pengap pagi ini
The burial shroud is brought by close family	Kain kafan dibawa keluarga dekat
Legions of fans filled the stadium	Legiun penggemar memadati stadion
I am carrying a new parachute today	Aku membawa parasut baru hari ini
The letter has already received a disposition	Surat itu sudah mendapat disposisi
You should not twist that fact	Kamu jangan pelintir fakta itu
The projectile moves at high speed	Proyektil meluncur dengan kecepatan tinggi
Magnetic flux changes the electric field	Fluks magnetik mengubah medan listrik
The traction of this car is quite good	Traksi mobil ini cukup baik
The door hinge is rusty	Engsel pintu itu berkarat
The light bulb is broken	Bohlam lampu itu rusak
He enjoys expensive cigars every night	Dia menikmati cerutu mahal setiap malam
The fish swims in the pond near the house	Ikan berenang di empang dekat rumah
The flight experienced turbulent weather	Penerbangan mengalami cuaca turbulen
That pregnancy is a breech pregnancy	Kehamilan itu kehamilan sungsang
The protagonist in this story is brave	Protagonis dalam cerita ini berani
I bought new shoe polish	Saya membeli semir sepatu baru
He studies gynecology at the university	Dia belajar ilmu ginekologi di universitas
He chose the effective vasectomy method	Dia memilih metode vasektomi efektif
The motorcycle handlebar is rusty	Stang motor itu berkarat
He hides a sharp dagger	Dia menyembunyikan belati tajam
The beautiful scenery in the canyon	Pemandangan indah di ngarai itu
The country is controlled by an economic oligarchy	Negara itu dikuasai oligarki ekonomi
I still don't feel at home here	Aku belum kerasan di sini
Sift the rice before cooking in the morning	Ayak beras sebelum dimasak pagi
He used a crowbar to open the door	Dia menggunakan linggis untuk membuka pintu
He experienced a mild concussion	Dia mengalami gegar otak ringan
I sip warm tea this morning	Aku seruput teh hangat pagi ini
Fresh skipjack tuna from the market	Ikan cakalang segar dari pasar
The esophagus connects the mouth and the stomach	Esofagus menghubungkan mulut dan lambung
The family chose cremation for the deceased	Keluarga memilih kremasi untuk almarhum
Their relationship is naturally mutualistic	Hubungan mereka bersifat mutualistis alami
He follows regular bodybuilding training	Dia mengikuti latihan binaraga rutin
He is considered his boss's lackey	Dia dianggap kacung bosnya
The doormat is made from natural fibers	Keset itu terbuat dari serat alami
Don't watch that porn video	Jangan tonton video bokep itu
The Gothic church architectural style is beautiful	Gaya arsitektur gereja gotik indah
Conjunction connects two sentences	Konjungsi menghubungkan dua kalimat
The firecracker contains sharp gunpowder	Petasan itu berisi mesiu tajam
Bread crumbs are scattered on the table	Remah roti berserakan di meja
The bicycle saddle has just been replaced	Sadel sepeda itu baru diganti
The caldera of the mountain is very wide	Kaldera gunung itu luas sekali
He was arrested for being a pimp	Dia ditangkap karena jadi germo
The leaf cuticle protects the plant	Kutikula daun melindungi tumbuhan
The sensation of the larynx in the throat is felt	Rasa laring di tenggorokan terasa
The sound of the explosion was loud	Suara eksplosi terdengar keras
The symphony played melodiously	Simfoni itu mengalun merdu
I wear a poncho when it rains	Aku memakai ponco saat hujan
He remains persistent in facing challenges	Dia tetap persisten menghadapi tantangan
The chameleon changes color on the leaf	Bunglon berubah warna di daun
He applied for a new home mortgage	Dia mengajukan hipotek rumah baru
He took a shovel from the shed	Dia mengambil sekop dari gudang
I poke a friend in class	Aku colek teman di kelas
The graffiti on the city wall is interesting	Grafiti di dinding kota menarik
He giggled hearing the joke	Dia cekikik mendengar lelucon itu
The inauguration ceremony went smoothly	Upacara inaugurasi berjalan lancar
The meat is full of rotten maggots	Daging itu penuh belatung busuk
I write a daily diary	Aku menulis diari harian
The child has scabies on the skin	Anak itu terkena kudis kulit
The fishing rod is strong in holding the fish	Joran itu kuat menahan ikan
An error occurred in the computer system	Terjadi galat pada sistem komputer
The hero was posthumously awarded	Pahlawan itu dianugerahi anumerta
The dwarf lives in the forest	Kurcaci itu tinggal di hutan
The plan includes contingency factors	Rencana mencakup faktor kontingensi
The walls of the house are covered with black soot	Dinding rumah penuh jelaga hitam
My favorite zodiac sign is Sagittarius	Zodiak favoritku adalah Sagitarius
His skin is easily affected by atopic conditions	Kulitnya mudah terkena atopik
Children like to listen to fables	Anak-anak suka mendengarkan fabel
He plays the octave smoothly	Dia memainkan oktaf dengan lancar
A pulley helps lift heavy loads	Katrol membantu mengangkat beban berat
The car's speedometer shows a high speed	Spidometer mobil menunjukkan kecepatan tinggi
Laundry in the corner of the bathroom	Binatu di sudut kamar mandi
I forgot to bring toothpaste today	Saya lupa membawa odol hari ini
Alum helps to refresh the skin	Air tawas membantu menyegarkan kulit
He is interested in fossil paleontology	Dia tertarik dengan paleontologi fosil
Reptiles live in various habitats	Reptilia hidup di berbagai habitat
The police arrested the crime suspect	Polisi menangkap suspek kejahatan itu
Tonight's cabaret show is interesting	Pertunjukan kabaret malam ini menarik
She is wearing a red tunic	Dia mengenakan tunik merah
The team tested a new prototype today	Tim menguji purwarupa baru hari ini
The plane performed amazing aerobatics	Pesawat itu melakukan aerobatik menakjubkan
She felt ecstasy when winning	Dia merasakan ekstase saat menang
The man's Adam's apple protrudes clearly	Jakun pria itu menonjol jelas
Gypsy music livens up the atmosphere	Musik gipsi menghidupkan suasana
We stayed in a comfortable bungalow	Kami menginap di bungalo nyaman
The teacher wears thick sideburns	Pak guru memakai cambang lebat
Paparan paparazzi disturb celebrities	Paparan paparazi mengganggu selebriti
The baboon is funny and agile	Babun itu lucu dan lincah
The incumbent won the rerun election	Inkumben memenangkan pemilihan ulang
He is speaking through a megaphone	Dia berbicara lewat megafon
The sheikh teaches the knowledge of Sufism	Syekh mengajarkan ilmu tasawuf
The lamp lights up the night road	Pelita menerangi jalan malam
Sinful acts must be avoided together	Maksiat harus dijauhi bersama-sama
The tomb is considered a sacred place	Makam itu dianggap tempat keramat
He is a talented young man from Malacca	Dia pemuda malaka berbakat
The plant vascular system functions optimally	Sistem vaskular tanaman berfungsi optimal
The church liturgy takes place solemnly	Liturgi gereja berlangsung khidmat
Fresh clover leaves for salad	Daun semanggi segar untuk salad
We celebrate the Eucharist together	Kami merayakan ekaristi bersama
This heart is full of love	Kalbu ini penuh dengan cinta
The Shafi'i method is easy to understand	Metode Syafii mudah dipahami
Noni tea helps digestion	Teh mengkudu membantu pencernaan
English vocabulary is extensive	Kosa kata bahasa Inggris luas
Psychomotor exercises improve hand skills	Latihan psikomotor meningkatkan keterampilan tangan
Spinach vegetables are rich in folate	Sayur bayam kaya akan folat
He ran away from the danger	Dia lari dar bahaya itu
Hedonism often misleads the mind	Hedonisme sering kali menyesatkan pikiran
The bowl contains warm soup	Mangkok itu berisi sup hangat
We met last year	Kami bertemu tahun lalu
Acetate fabric feels smooth	Kain asetat terasa halus
Tertiary education is important for a career	Pendidikan tersier penting bagi karier
Hair follicles undergo active growth	Folikel rambut mengalami pertumbuhan aktif
Write the first paragraph clearly	Tulis alinea pertama dengan jelas
The number of leukocytes in the blood increases	Jumlah leukosit dalam darah meningkat
I like back massages	Saya suka pijit punggung
Voice modulation is important in communication	Modulasi suara penting dalam komunikasi
The role of the priesthood in Islamic tradition	Peran imamat dalam tradisi Islam
Chloride is important in the body's electrolytes	Klorida penting dalam elektrolit tubuh
The deacon leads the worship service this Sunday	Diakon memimpin ibadah minggu ini
The family patriarch governs the tradition	Patriark keluarga mengatur tradisi tersebut
He has strong determination	Dia memiliki tekad kuat
My leg feels pain from varicose veins	Kaki saya terasa sakit varises
Syllogism helps to understand logical arguments	Silogisme membantu memahami argumen logis
The baby is sleeping soundly	Jabang bayi tertidur nyenyak
Sahaya sings on the stage at night	Sahaya menyanyi di panggung malam
The Indonesian lexicon is becoming richer	Leksikon bahasa Indonesia semakin kaya
Gauze protects the wound from dust	Kasa melindungi luka dari debu
That burlap bag is strong and durable	Tas goni itu kuat dan tahan
Plants grow well with mulch	Tanaman tumbuh subur dengan mulsa
Borax is used to clean stains	Boraks digunakan untuk membersihkan noda
Students' intention to learn increases	Intensi pelajar dalam belajar meningkat
The belief in animism is still alive	Kepercayaan animisme masih hidup
Wave oscillation affects the signal	Osilasi gelombang mempengaruhi sinyal
The child is suffering from mild dysentery	Anak itu terserang disentri ringan
The cavalry troops storm the battlefield	Pasukan kavaleri menyerbu medan perang
Nematodes live in moist soil	Nematoda hidup di tanah lembab
Negation changes the meaning of the sentence	Negasi mengubah makna kalimat tersebut
The farmer gives feed of coconut meal	Petani memberi pakan bungkil kelapa
Prophylaxis is important for health	Profilaksis penting untuk kesehatan
He has a mild congenital disorder	Dia memiliki kelainan kongenital ringan
The child let out a loud snort	Anak itu mengeluarkan dengus keras
The hypothalamus regulates the human body temperature	Hipotalamus mengatur suhu tubuh manusia
The sound of the trumpet echoed loudly	Suara sangkakala menggema keras
The Coptic Church in that city	Gereja Koptik di kota itu
The discussion is topical	Diskusi itu bersifat topikal
The doctor prescribed penicillin for the infection	Dokter meresepkan penisilin untuk infeksi
A positive ion is called a cation	Ion positif disebut kation
His presentation sounded bombastic	Presentasi dia terdengar bombastis
His lifestyle feels decadent	Gaya hidupnya terasa dekaden
I want a new ear piercing	Aku ingin tindik telinga baru
He has high pretensions towards work	Dia memiliki pretensi tinggi terhadap pekerjaan
The taste of cumin in the delicious curry	Rasa jintan dalam kari lezat
The patient is experiencing mild metabolic acidosis	Pasien mengalami asidosis metabolik ringan
The Earth rotates around its axis	Rotasi bumi mengelilingi aksisnya
He nodded when his task was explained to him	Dia manggut saat dijelaskan tugasnya
Camera fixation on the main object	Fiksasi kamera pada objek utama
The calf drinks from the mother's udder	Anak sapi minum dari ambing ibu
English verb conjugation	Konjugasi kata kerja bahasa Inggris
I try to pry out that nail	Aku coba cungkil paku itu
He has a secret mistress	Dia memiliki gundik rahasia
Spinach leaves contain high oxalate levels	Daun bayam mengandung oksalat tinggi
Detonation was heard from afar	Detonasi terdengar dari kejauhan
Light undergoes thin diffraction	Cahaya mengalami difraksi tipis
The child is playing with a slingshot	Anak itu bermain dengan katapel
This compound functions as a medicine	Senyawa ini berfungsi sebagai obat
That pencil contains natural graphite	Pensil itu mengandung grafit alami
The baby is experiencing mild jaundice	Bayi itu mengalami ikterus ringan
She works in a night brothel	Dia bekerja di bordil malam
The police officer leads the night patrol	Opsir polisi memimpin patroli malam
Tilapia fish in the backyard pond	Ikan mujair di kolam belakang
The whip wind splits the night	Angin cemeti membelah malam
The baby died due to asphyxia	Bayi itu meninggal karena asfiksia
The dilution process reduces the concentration of a substance	Proses dilusi mengurangi konsentrasi zat
My nails are clean with acetone	Kuku saya bersih dengan aseton
I saw an interesting advertisement today	Saya melihat advertensi menarik hari ini
The cassowary walks in the dense forest	Kasuari berjalan di hutan lebat
The chess pawn moves forward	Pion catur bergerak ke depan
He is too arrogant when facing problems	Dia terlalu pongah menghadapi masalah
He feels deep resentment towards his enemy	Dia merasa kesumat pada musuhnya
The octopus's tentacles touch the coral rock	Tentakel gurita menyentuh batu karang
The child suffers from mild thalassemia	Anak itu mengidap talasemia ringan
I attended the witness deposition yesterday	Saya menghadiri deposisi saksi kemarin
The micrometer measures the thickness of the paper	Mikrometer mengukur ketebalan kertas
He chose to live in celibacy	Dia memilih hidup dalam selibat
The animal's mandible is strong in resisting pressure	Mandibula hewan itu kuat menahan tekanan
My study period is two months	Tempoh belajar saya dua bulan
The patient's hematocrit value decreases	Nilai hematokrit pasien menurun
Cadmium is harmful to human health	Kadmium berbahaya bagi kesehatan manusia
Candles are made from white paraffin	Lilin dibuat dari parafin putih
The child was diagnosed with hydrocephalus	Anak itu didiagnosis hidrosefalus
Electric relay controls the flow of current	Relai listrik mengatur aliran arus
The doctor writes a new medicine prescription	Dokter menulis preskripsi obat baru
The oil fractionation process is important	Proses fraksionasi minyak penting
Ancient writing is written on papyrus	Tulisan kuno tertulis di papirus
I bought new shoes	Saya membeli kasut baru
The sheep is eating grass	Biri-biri itu sedang makan rumput
The team successfully made a quick interception	Tim berhasil melakukan intersepsi cepat
The persimmon fruit is on the tall tree	Buah kesemek di pohon tinggi
Collateral damage in this war	Kerugian kolateral dalam perang ini
The credentials are complete and trustworthy	Kredensialnya lengkap dan terpercaya
The circumcision process went smoothly	Proses sirkumsisi berjalan lancar
Their relationship remains strictly platonic	Hubungan mereka tetap platonik saja
The doctor recommends a hysterectomy surgery	Dokter menyarankan operasi histerektomi
The doctor performed excision of a small tumor	Dokter melakukan eksisi tumor kecil
Synapses connect the neurons of the brain	Sinapsis menghubungkan neuron-neuron otak
Alchemy transforms ordinary metals	Alkimia mengubah logam biasa
The apical structure of the leaf is clearly different	Struktur apikal daun berbeda jelas
I like to eat grilled chicken gizzards	Saya suka makan ampela bakar
He needs a new leg prosthesis	Dia membutuhkan prostesis kaki baru
Color alteration in old paintings	Alterasi warna pada lukisan tua
The doctor prescribed cortisone today	Dokter meresepkan kortison hari ini
The doctor diagnosed cervical papilloma	Dokter mendiagnosis papiloma serviks
He is known as a skilled psychic	Dia dikenal sebagai cenayang handal
the night sky is full of beautiful stars	langit malam penuh gemintang indah
The apatite stone is light green in color	Batu apatit berwarna hijau muda
The baritone singer is extraordinary	Penyanyi bariton itu luar biasa
The horse made a whinnying sound	Kuda itu mengeluarkan suara ringkik
The number of basophils in the blood increases	Jumlah basofil dalam darah meningkat
The horse has a long mane	Kuda itu memiliki surai panjang
This game relies on tactile sensations	Permainan ini mengandalkan sensasi taktil
Crustaceans live in the deep sea	Krustasea hidup di laut dalam
Chloroquine is used for malaria	Klorokuin digunakan untuk malaria
Chauvinism damages international relations	Chauvinisme merusak hubungan internasional
The comrade helps in his task	Kamerad membantu dalam tugasnya
scrambled eggs in the morning	telur orak-arik di pagi hari
Expectorant medicine helps with productive coughs	Obat ekspektoran membantu batuk berdahak
I am learning to calculate the area of a parallelogram	Saya belajar menghitung luas jajar genjang
Butane flame ignites easily	Api butana mudah menyala
Prions cause neurodegenerative diseases	Prion menyebabkan penyakit neurodegeneratif
Parochial views hinder innovation	Pandangan parokial menghambat inovasi
Procreation is important in survival	Prokreasi penting dalam kelangsungan hidup
Potassium permanganate solution is purple in color	Larutan permanganat berwarna ungu
The meeting was conducted clandestinely	Pertemuan itu dilakukan secara klandestin
The word homonym is often confusing	Kata homonim sering membingungkan
Monomethylhydrazine is used as fuel	Monometilhidrazina digunakan sebagai bahan bakar
This column discusses the latest technology	Kolum ini membahas teknologi terbaru
I uploaded the holiday photo yesterday	Aku punggah foto liburan kemarin
My studies focus on ophthalmology	Kuliah saya fokus pada oftalmologi
The doctor detected the patient's splenomegaly	Dokter mendeteksi splenomegali pasien
The cannabis plant grows lush	Tanaman kanabis tumbuh subur
The crackling sound of the guitar flows	Suara kretekan gitar mengalun
Desiccators are used to store materials	Desikator digunakan untuk menyimpan bahan
He studies music at the conservatory	Dia belajar musik di konservatorium
The doctor diagnosed chronic vasculitis	Dokter mendiagnosis vaskulitis kronis
The genitive sentence indicates possession	Kalimat genitif menunjukkan kepemilikan
The mirror has a convex shape	Cermin itu memiliki bentuk konveks
The lipolysis process burns fat	Proses lipolisis membakar lemak
Xenophobia threatens social harmony	Xenofobia mengancam kerukunan masyarakat
The doctor explains the hysteroscopy procedure	Dokter menjelaskan prosedur histeroskopi
The word homophones often confuse learners	Kata homofon sering membingungkan pembelajar
The pacification effort brings peace	Upaya pasifikasi membawa kedamaian
Radioactive cesium was found in the laboratory	Radioaktif sesium ditemukan di laboratorium
Squirrels run on the tree	Tupai-tupai berlari di pohon
It turns out that the news is a hoax continuously	Berita itu ternyata hoaks terus
We are playing baccarat tonight	Kami bermain bakarat malam ini
Homomorphisms are important in abstract algebra	Homomorfisme penting dalam aljabar abstrak
The view of panpsychism attracts the attention of philosophers	Pandangan panpsikisme menarik perhatian filsuf
That child likes to play unicorn	Anak itu suka main unikorn